a	a
a-ba-giua	a b a g i u a
a-ba-toa	a b a t o a
a-di-đà	a d i đ à
a-dong	a d o n g
a-dốt	a d ố t
a-ga	a g a
a-giăng	a g i ă n g
a-giăng-đa	a g i ă n g đ a
a-gon	a g o n
a-la	a l a
a-la-hán	a l a h á n
a-la-mốt	a l a m ố t
a-la-văng	a l a v ă n g
a-len	a l e n
a-lu-min	a l u m i n
a-léc	a l é c
a-lê	a l ê
a-lô	a l ô
a-ma-tơ	a m a t ơ
a-mam	a m a m
a-me-ri-xi	a m e r i x i
a-men	a m e n
a-mi	a m i
a-mi-nô	a m i n ô
a-mi-ăng	a m i ă n g
a-mi-đan	a m i đ a n
a-min	a m i n
a-míp	a m í p
a-mô-ni-ác	a m ô n i á c
a-mô-ni-ắc	a m ô n i ắ c
a-măng	a m ă n g
a-nan-gin	a n a n g i n
a-ni-lin	a n i l i n
a-ni-ôn	a n i ô n
a-ni-ông	a n i ô n g
a-nô-phen	a n ô p h e n
a-nốt	a n ố t
a-pa-tít	a p a t í t
a-pác-thai	a p á c t h a i
a-pê-ri-típ	a p ê r i t í p
a-rập	a r ậ p
a-sen	a s e n
a-sin	a s i n
a-ta-tin	a t a t i n
a-ti-sô	a t i s ô
a-trô-pin	a t r ô p i n
a-tu-la	a t u l a
a-tua-đờ-rôn	a t u a đ ờ r ô n
a-vi	a v i
a-vô-ca	a v ô c a
a-văng	a v ă n g
a-văng-ta	a v ă n g t a
a-văng-xê	a v ă n g x ê
a-xen	a x e n
a-xit	a x i t
a-xê-ti-len	a x ê t i l e n
a-xê-tic	a x ê t i c
a-xê-ton	a x ê t o n
a-xê-tôn	a x ê t ô n
a-xít	a x í t
a-đa	a đ a
a-đam	a đ a m
a-đi-xơn	a đ i x ơ n
aa	a a
abbey	a b b e y
abbie	a b b i e
abc	a b c
abi	a b i
ac	a c
accent	a c c e n t
accord	a c c o r d
action	a c t i o n
ada	a d a
adam	a d a m
adams	a d a m s
adapter	a d a p t e r
adaptor	a d a p t o r
add	a d d
adenauer	a d e n a u e r
adn	a d n
adolf	a d o l f
ae	a e
afghanistan	a f g h a n i s t a n
age	a g e
agenda	a g e n d a
ah	a h
ai	a i
air	a i r
aires	a i r e s
airways	a i r w a y s
aix	a i x
ak	a k
akau	a k a u
akiko	a k i k o
akira	a k i r a
akura	a k u r a
al	a l
ala	a l a
aladay	a l a d a y
alba	a l b a
album	a l b u m
albums	a l b u m s
ale	a l e
alex	a l e x
alexandra	a l e x a n d r a
alexandre	a l e x a n d r e
alexandrov	a l e x a n d r o v
alfie	a l f i e
alfredo	a l f r e d o
alice	a l i c e
all	a l l
allen	a l l e n
allianz	a l l i a n z
alo	a l o
aloha	a l o h a
alpha	a l p h a
alsop	a l s o p
alternator	a l t e r n a t o r
am	a m
am-mô-ni-ắc	a m m ô n i ắ c
am-pe	a m p e
am-pun	a m p u n
amazon	a m a z o n
american	a m e r i c a n
amex	a m e x
amidan	a m i d a n
amip	a m i p
an	a n
an-bom	a n b o m
an-bu-min	a n b u m i n
an-ca-lo-ít	a n c a l o í t
an-ca-lô-ít	a n c a l ô í t
an-côn	a n c ô n
an-gin	a n g i n
an-go-rít	a n g o r í t
an-gô-rít	a n g ô r í t
an-két	a n k é t
an-ma-nác	a n m a n á c
an-pha	a n p h a
an-pha-bê	a n p h a b ê
an-te	a n t e
an-ten	a n t e n
an-ti-mon	a n t i m o n
an-ti-pi-rin	a n t i p i r i n
an-tra-xít	a n t r a x í t
an-tô	a n t ô
an-tơ-ra-xít	a n t ơ r a x í t
an-đe-hít	a n đ e h í t
an-đê-hít	a n đ ê h í t
ana	a n a
anaconda	a n a c o n d a
anchor	a n c h o r
and	a n d
anderson	a n d e r s o n
andre	a n d r e
andrea	a n d r e a
andrey	a n d r e y
android	a n d r o i d
andy	a n d y
ang	a n g
angela	a n g e l a
angeles	a n g e l e s
angelina	a n g e l i n a
angie	a n g i e
anh	a n h
anh-te	a n h t e
anh-te-phôn	a n h t e p h ô n
anh-te-ruýp-tơ	a n h t e r u ý p t ơ
anna	a n n a
annie	a n n i e
anthony	a n t h o n y
antisense	a n t i s e n s e
antoine	a n t o i n e
anubis	a n u b i s
ao	a o
ao-xơ	a o x ơ
aoki	a o k i
aoyagi	a o y a g i
apheng	a p h e n g
app	a p p
apple	a p p l e
applications	a p p l i c a t i o n s
apt	a p t
arabia	a r a b i a
arc	a r c
arena	a r e n a
argentina	a r g e n t i n a
arista	a r i s t a
armand	a r m a n d
arsenal	a r s e n a l
arthur	a r t h u r
article	a r t i c l e
asean	a s e a n
ashley	a s h l e y
asia	a s i a
aspirin	a s p i r i n
astro	a s t r o
at	a t
atm	a t m
atp	a t p
atsuji	a t s u j i
au	a u
au-xơ	a u x ơ
auckland	a u c k l a n d
audi	a u d i
audio	a u d i o
audrey	a u d r e y
augustus	a u g u s t u s
australia	a u s t r a l i a
auto	a u t o
avenue	a v e n u e
avery	a v e r y
awards	a w a r d s
axit	a x i t
ay	a y
aybar	a y b a r
azora	a z o r a
b	b
ba	b a
ba-dan	b a d a n
ba-dô-ca	b a d ô c a
ba-dơ	b a d ơ
ba-ga	b a g a
ba-gác	b a g á c
ba-hi	b a h i
ba-ke-lit	b a k e l i t
ba-ke-lít	b a k e l í t
ba-lát	b a l á t
ba-lê	b a l ê
ba-lô	b a l ô
ba-lông	b a l ô n g
ba-ren	b a r e n
ba-ri	b a r i
ba-ri-e	b a r i e
ba-ta	b a t a
ba-tanh	b a t a n h
ba-ti-nê	b a t i n ê
ba-toong	b a t o o n g
ba-trui	b a t r u i
ba-tui	b a t u i
ba-tê	b a t ê
ba-tê-sô	b a t ê s ô
ba-tú	b a t ú
ba-tăng	b a t ă n g
ba-xí	b a x í
ba-đờ-xuy	b a đ ờ x u y
baby	b a b y
bac	b a c
baccarat	b a c c a r a t
back	b a c k
backdrop	b a c k d r o p
baghdad	b a g h d a d
baghdadi	b a g h d a d i
bahamas	b a h a m a s
bahrain	b a h r a i n
bai	b a i
bailini	b a i l i n i
baines	b a i n e s
bale	b a l e
bali	b a l i
ballad	b a l l a d
ballet	b a l l e t
baltimore	b a l t i m o r e
bam	b a m
ban	b a n
ban-công	b a n c ô n g
ban-giô	b a n g i ô
ban-me	b a n m e
bancha	b a n c h a
bang	b a n g
bangkok	b a n g k o k
banh	b a n h
banks	b a n k s
bao	b a o
bar	b a r
barca	b a r c a
barcelona	b a r c e l o n a
barrack	b a r r a c k
bart	b a r t
base	b a s e
basel	b a s e l
baskerville	b a s k e r v i l l e
basque	b a s q u e
batista	b a t i s t a
battery	b a t t e r y
battle	b a t t l e
bau	b a u
bavaria	b a v a r i a
bay	b a y
bay-on-nét	b a y o n n é t
bazan	b a z a n
be	b e
be-ri-li	b e r i l i
beach	b e a c h
bear	b e a r
beatles	b e a t l e s
becca	b e c c a
becker	b e c k e r
beckham	b e c k h a m
becky	b e c k y
beef	b e e f
beefsteak	b e e f s t e a k
beer	b e e r
begin	b e g i n
begoro	b e g o r o
beige	b e i g e
belgrade	b e l g r a d e
bell	b e l l
bella	b e l l a
bellamy	b e l l a m y
bem	b e m
ben	b e n
ben-den	b e n d e n
ben-tô-nít	b e n t ô n í t
beng	b e n g
bengal	b e n g a l
benitez	b e n i t e z
benjamin	b e n j a m i n
bentley	b e n t l e y
benz	b e n z
beo	b e o
berle	b e r l e
berlin	b e r l i n
bernabeu	b e r n a b e u
bernadette	b e r n a d e t t e
bernd	b e r n d
best	b e s t
beta	b e t a
beverly	b e v e r l y
bi	b i
bi-a	b i a
bi-da	b i d a
bi-da-ma	b i d a m a
bi-dăng-tin	b i d ă n g t i n
bi-ki-ni	b i k i n i
bi-tum	b i t u m
bi-ăng-tin	b i ă n g t i n
bi-đông	b i đ ô n g
bia	b i a
bieber	b i e b e r
big	b i g
bilbo	b i l b o
bill	b i l l
bin	b i n
bin-đinh	b i n đ i n h
bing	b i n g
bingley	b i n g l e y
binh	b i n h
birmingham	b i r m i n g h a m
bismol	b i s m o l
biêm	b i ê m
biên	b i ê n
biêng	b i ê n g
biêt	b i ê t
biêu	b i ê u
biếc	b i ế c
biếm	b i ế m
biến	b i ế n
biếng	b i ế n g
biết	b i ế t
biếu	b i ế u
biền	b i ề n
biều	b i ề u
biển	b i ể n
biểu	b i ể u
biễu	b i ễ u
biện	b i ệ n
biệt	b i ệ t
black	b l a c k
blackberry	b l a c k b e r r y
blade	b l a d e
blair	b l a i r
blue	b l u e
blues	b l u e s
bluetooth	b l u e t o o t h
bmt	b m t
bmw	b m w
bo	b o
bo-nê	b o n ê
boa	b o a
bobby	b o b b y
bodega	b o d e g a
boeing	b o e i n g
bollywood	b o l l y w o o d
bom	b o m
bom-bê	b o m b ê
bon	b o n
bon-nê	b o n n ê
bon-sê-vích	b o n s ê v í c h
bonaparte	b o n a p a r t e
bond	b o n d
bong	b o n g
bonus	b o n u s
boong	b o o n g
boong-ke	b o o n g k e
boots	b o o t s
bordeaux	b o r d e a u x
borgia	b o r g i a
boris	b o r i s
bose	b o s e
bosnia	b o s n i a
boston	b o s t o n
botanical	b o t a n i c a l
botton	b o t t o n
boulevard	b o u l e v a r d
bourbon	b o u r b o n
bowling	b o w l i n g
box	b o x
boy	b o y
boóc	b o ó c
boóc-tê	b o ó c t ê
boóc-đô	b o ó c đ ô
boóng	b o ó n g
bp	b p
brad	b r a d
braga	b r a g a
brand	b r a n d
brandy	b r a n d y
brasil	b r a s i l
brazil	b r a z i l
break	b r e a k
bremen	b r e m e n
brest	b r e s t
bridge	b r i d g e
brisbane	b r i s b a n e
british	b r i t i s h
britney	b r i t n e y
briton	b r i t o n
broadway	b r o a d w a y
brom	b r o m
bronx	b r o n x
brooklyn	b r o o k l y n
brown	b r o w n
browse	b r o w s e
browsing	b r o w s i n g
bruni	b r u n i
brute	b r u t e
bruyne	b r u y n e
bruzon	b r u z o n
bryant	b r y a n t
bu	b u
bu-gi	b u g i
bu-lông	b u l ô n g
bu-đâng	b u đ â n g
bua	b u a
budapest	b u d a p e s t
buenos	b u e n o s
bui	b u i
buler	b u l e r
bulgaria	b u l g a r i a
bullets	b u l l e t s
bum	b u m
bun	b u n
bung	b u n g
bunga	b u n g a
burger	b u r g e r
burke	b u r k e
bus	b u s
bush	b u s h
butch	b u t c h
buy-rô	b u y r ô
buy-vét	b u y v é t
buôi	b u ô i
buôn	b u ô n
buông	b u ô n g
buýp-phê	b u ý p p h ê
buýt	b u ý t
buốt	b u ố t
buồi	b u ồ i
buồm	b u ồ m
buồn	b u ồ n
buồng	b u ồ n g
buổi	b u ổ i
buộc	b u ộ c
buộm	b u ộ m
buột	b u ộ t
buớc	b u ớ c
by	b y
bye	b y e
bà	b à
bà-la-môn	b à l a m ô n
bài	b à i
bàm	b à m
bàn	b à n
bàng	b à n g
bành	b à n h
bành-tô	b à n h t ô
bào	b à o
bàu	b à u
bày	b à y
bá	b á
bác	b á c
bách	b á c h
bái	b á i
bái-công	b á i c ô n g
bám	b á m
bán	b á n
báng	b á n g
bánh	b á n h
báo	b á o
bát	b á t
bát-két	b á t k é t
bát-kết	b á t k ế t
bát-tràng	b á t t r à n g
báu	b á u
báy	b á y
bân	b â n
bâng	b â n g
bâu	b â u
bây	b â y
bã	b ã
bãi	b ã i
bãng	b ã n g
bão	b ã o
bè	b è
bèm	b è m
bèn	b è n
bèo	b è o
bé	b é
béc	b é c
béc-giê	b é c g i ê
bén	b é n
béng	b é n g
béo	b é o
bép	b é p
bét	b é t
bê	b ê
bê-rê	b ê r ê
bê-ta	b ê t a
bê-tông	b ê t ô n g
bên	b ê n
bênh	b ê n h
bêu	b ê u
bì	b ì
bìa	b ì a
bìm	b ì m
bình	b ì n h
bình-toong	b ì n h t o o n g
bìu	b ì u
bí	b í
bích	b í c h
bích-câu	b í c h c â u
bích-cốt	b í c h c ố t
bích-qui	b í c h q u i
bích-quy	b í c h q u y
bích-toong	b í c h t o o n g
bím	b í m
bín	b í n
bính	b í n h
bíp	b í p
bíp-tết	b í p t ế t
bít	b í t
bít-cốt	b í t c ố t
bít-kê	b í t k ê
bít-mút	b í t m ú t
bít-quy	b í t q u y
bít-tông	b í t t ô n g
bít-tết	b í t t ế t
bíu	b í u
bò	b ò
bòi	b ò i
bòm	b ò m
bòn	b ò n
bòng	b ò n g
bó	b ó
bóc	b ó c
bói	b ó i
bón	b ó n
bóng	b ó n g
bóp	b ó p
bót	b ó t
bô	b ô
bô-bin	b ô b i n
bô-xít	b ô x í t
bô-đê	b ô đ ê
bôi	b ô i
bôm	b ô m
bôm-bay	b ô m b a y
bôn	b ô n
bôn-sê-vích	b ô n s ê v í c h
bông	b ô n g
bông-bay	b ô n g b a y
bông-xoa	b ô n g x o a
bõ	b õ
bõm	b õ m
bõng	b õ n g
bù	b ù
bù-loong	b ù l o o n g
bù-ét	b ù é t
bùa	b ù a
bùi	b ù i
bùm	b ù m
bùn	b ù n
bùng	b ù n g
bú	b ú
búa	b ú a
búi	b ú i
bún	b ú n
búng	b ú n g
búp	b ú p
búp-bê	b ú p b ê
búp-phê	b ú p p h ê
bút	b ú t
băm	b ă m
băn	b ă n
băng	b ă n g
băng-ca	b ă n g c a
băng-giô	b ă n g g i ô
băng-rôn	b ă n g r ô n
băng-túp	b ă n g t ú p
bĩ	b ĩ
bĩnh	b ĩ n h
bĩu	b ĩ u
bũm	b ũ m
bơ	b ơ
bơ-lu-dông	b ơ l u d ô n g
bơ-mấm	b ơ m ấ m
bơ-noong	b ơ n o o n g
bơ-rơ-vê	b ơ r ơ v ê
bơi	b ơ i
bơm	b ơ m
bơn	b ơ n
bư	b ư
bưa	b ư a
bưng	b ư n g
bưu	b ư u
bươi	b ư ơ i
bươm	b ư ơ m
bươn	b ư ơ n
bương	b ư ơ n g
bươu	b ư ơ u
bước	b ư ớ c
bướm	b ư ớ m
bướng	b ư ớ n g
bướp	b ư ớ p
bướu	b ư ớ u
bườm	b ư ờ m
bưởi	b ư ở i
bượt	b ư ợ t
bạ	b ạ
bạc	b ạ c
bạch	b ạ c h
bại	b ạ i
bạm	b ạ m
bạn	b ạ n
bạng	b ạ n g
bạnh	b ạ n h
bạo	b ạ o
bạp	b ạ p
bạt	b ạ t
bạu	b ạ u
bả	b ả
bải	b ả i
bản	b ả n
bảng	b ả n g
bảnh	b ả n h
bảnlà	b ả n l à
bảo	b ả o
bảu	b ả u
bảy	b ả y
bấc	b ấ c
bấm	b ấ m
bấn	b ấ n
bấng	b ấ n g
bấp	b ấ p
bất	b ấ t
bấu	b ấ u
bấy	b ấ y
bầm	b ầ m
bần	b ầ n
bầng	b ầ n g
bầu	b ầ u
bầy	b ầ y
bẩm	b ẩ m
bẩn	b ẩ n
bẩu	b ẩ u
bẩy	b ẩ y
bẫm	b ẫ m
bẫn	b ẫ n
bẫng	b ẫ n g
bẫu	b ẫ u
bẫy	b ẫ y
bậc	b ậ c
bậm	b ậ m
bận	b ậ n
bậng	b ậ n g
bập	b ậ p
bật	b ậ t
bậu	b ậ u
bậy	b ậ y
bắc	b ắ c
bắn	b ắ n
bắng	b ắ n g
bắp	b ắ p
bắt	b ắ t
bắt-tê	b ắ t t ê
bằm	b ằ m
bằn	b ằ n
bằng	b ằ n g
bẳm	b ẳ m
bẳn	b ẳ n
bẳng	b ẳ n g
bẵm	b ẵ m
bẵng	b ẵ n g
bặc	b ặ c
bặm	b ặ m
bặn	b ặ n
bặng	b ặ n g
bặp	b ặ p
bặt	b ặ t
bẹ	b ẹ
bẹc	b ẹ c
bẹn	b ẹ n
bẹo	b ẹ o
bẹp	b ẹ p
bẹt	b ẹ t
bẻ	b ẻ
bẻm	b ẻ m
bẻo	b ẻ o
bẽ	b ẽ
bẽn	b ẽ n
bẽo	b ẽ o
bế	b ế
bến	b ế n
bếnh	b ế n h
bếp	b ế p
bết	b ế t
bề	b ề
bền	b ề n
bềnh	b ề n h
bều	b ề u
bể	b ể
bển	b ể n
bểnh	b ể n h
bễ	b ễ
bệ	b ệ
bệch	b ệ c h
bện	b ệ n
bệnh	b ệ n h
bệp	b ệ p
bệt	b ệ t
bệu	b ệ u
bỉ	b ỉ
bỉm	b ỉ m
bỉnh	b ỉ n h
bỉu	b ỉ u
bị	b ị
bịa	b ị a
bịch	b ị c h
bịn	b ị n
bịnh	b ị n h
bịp	b ị p
bịt	b ị t
bịu	b ị u
bọ	b ọ
bọc	b ọ c
bọn	b ọ n
bọng	b ọ n g
bọp	b ọ p
bọt	b ọ t
bỏ	b ỏ
bỏi	b ỏ i
bỏm	b ỏ m
bỏn	b ỏ n
bỏng	b ỏ n g
bố	b ố
bốc	b ố c
bốc-can	b ố c c a n
bốc-xít	b ố c x í t
bốc-xơ	b ố c x ơ
bối	b ố i
bốn	b ố n
bống	b ố n g
bốp	b ố p
bốt	b ố t
bốt-can	b ố t c a n
bốt-sét	b ố t s é t
bốt-tin	b ố t t i n
bồ	b ồ
bồ-tạt	b ồ t ạ t
bồi	b ồ i
bồm	b ồ m
bồn	b ồ n
bồng	b ồ n g
bổ	b ổ
bổi	b ổ i
bổn	b ổ n
bổng	b ổ n g
bỗ	b ỗ
bỗm	b ỗ m
bỗng	b ỗ n g
bộ	b ộ
bộc	b ộ c
bội	b ộ i
bộn	b ộ n
bộng	b ộ n g
bộp	b ộ p
bột	b ộ t
bớ	b ớ
bới	b ớ i
bớn	b ớ n
bớp	b ớ p
bớt	b ớ t
bờ	b ờ
bờ-lu	b ờ l u
bờ-lu-dông	b ờ l u d ô n g
bờ-lăng-tông	b ờ l ă n g t ô n g
bờ-rát-xa	b ờ r á t x a
bời	b ờ i
bờm	b ờ m
bờn	b ờ n
bở	b ở
bởi	b ở i
bỡ	b ỡ
bỡn	b ỡ n
bợ	b ợ
bợm	b ợ m
bợn	b ợ n
bợp	b ợ p
bợt	b ợ t
bụ	b ụ
bụa	b ụ a
bục	b ụ c
bụi	b ụ i
bụm	b ụ m
bụng	b ụ n g
bụp	b ụ p
bụt	b ụ t
bủ	b ủ
bủa	b ủ a
bủm	b ủ m
bủn	b ủ n
bủng	b ủ n g
bứ	b ứ
bứa	b ứ a
bức	b ứ c
bứng	b ứ n g
bứt	b ứ t
bừ	b ừ
bừa	b ừ a
bừng	b ừ n g
bửa	b ử a
bửng	b ử n g
bửu	b ử u
bữa	b ữ a
bự	b ự
bựa	b ự a
bực	b ự c
bựng	b ự n g
bựt	b ự t
c	c
ca	c a
ca-bi-nê	c a b i n ê
ca-bin	c a b i n
ca-cao	c a c a o
ca-chiu-sa	c a c h i u s a
ca-dong	c a d o n g
ca-ki	c a k i
ca-la-thầu	c a l a t h ầ u
ca-li	c a l i
ca-li-cô	c a l i c ô
ca-li-tê	c a l i t ê
ca-lo	c a l o
ca-líp	c a l í p
ca-lô	c a l ô
ca-me-ra	c a m e r a
ca-men	c a m e n
ca-mi-nhông	c a m i n h ô n g
ca-mi-ông	c a m i ô n g
ca-mê-ra	c a m ê r a
ca-na-pê	c a n a p ê
ca-níp	c a n í p
ca-nô	c a n ô
ca-nông	c a n ô n g
ca-phê-in	c a p h ê i n
ca-pô	c a p ô
ca-pốt	c a p ố t
ca-ra	c a r a
ca-ra-men	c a r a m e n
ca-ra-te	c a r a t e
ca-ri	c a r i
ca-rê	c a r ê
ca-rô	c a r ô
ca-rô-ten	c a r ô t e n
ca-sê	c a s ê
ca-sô	c a s ô
ca-ta-lô	c a t a l ô
ca-tang	c a t a n g
ca-ti-on	c a t i o n
ca-ti-ôn	c a t i ô n
ca-tốt	c a t ố t
ca-vát	c a v á t
ca-vét	c a v é t
ca-đi-mi	c a đ i m i
ca-đô	c a đ ô
cab	c a b
cabanas	c a b a n a s
cabin	c a b i n
cache	c a c h e
caesar	c a e s a r
cafe	c a f e
cafein	c a f e i n
café	c a f é
cai	c a i
calamine	c a l a m i n e
calcium	c a l c i u m
california	c a l i f o r n i a
callas	c a l l a s
calo	c a l o
cam	c a m
cam-nhông	c a m n h ô n g
cambridge	c a m b r i d g e
camel	c a m e l
camera	c a m e r a
cameron	c a m e r o n
cameroon	c a m e r o o n
campuchia	c a m p u c h i a
campus	c a m p u s
camry	c a m r y
can	c a n
can-ke	c a n k e
can-kê	c a n k ê
can-tua	c a n t u a
can-xi	c a n x i
can-đê-la	c a n đ ê l a
can-đơ-la	c a n đ ơ l a
canada	c a n a d a
canadian	c a n a d i a n
cang	c a n g
canh	c a n h
canh-ki-na	c a n h k i n a
cannes	c a n n e s
canon	c a n o n
cantona	c a n t o n a
canxi	c a n x i
canyon	c a n y o n
cao	c a o
cao-bồi	c a o b ồ i
cao-lanh	c a o l a n h
cao-su	c a o s u
cao-đài	c a o đ à i
cap	c a p
capello	c a p e l l o
cara	c a r a
carabao	c a r a b a o
carbin	c a r b i n
card	c a r d
cardiff	c a r d i f f
care	c a r e
carey	c a r e y
cari	c a r i
carl	c a r l
carla	c a r l a
carlee	c a r l e e
caro	c a r o
caroline	c a r o l i n e
carone	c a r o n e
carrick	c a r r i c k
carrier	c a r r i e r
carson	c a r s o n
carter	c a r t e r
casa	c a s a
casette	c a s e t t e
casey	c a s e y
cash	c a s h
casillas	c a s i l l a s
casino	c a s i n o
casinos	c a s i n o s
casio	c a s i o
cass	c a s s
cassette	c a s s e t t e
cassidy	c a s s i d y
castellazzi	c a s t e l l a z z i
cat	c a t
catalan	c a t a l a n
catalogue	c a t a l o g u e
caterpillar	c a t e r p i l l a r
catherine	c a t h e r i n e
catwalk	c a t w a l k
cau	c a u
cavalier	c a v a l i e r
cave	c a v e
cavi	c a v i
cay	c a y
cayman	c a y m a n
cc	c c
cd	c d
celeron	c e l e r o n
cello	c e l l o
cells	c e l l s
celtic	c e l t i c
cen-ti-mét	c e n t i m é t
cent	c e n t
centre	c e n t r e
cesare	c e s a r e
cha	c h a
cha!	c h a !
cha-cú	c h a c ú
chad	c h a d
chaebol	c h a e b o l
chai	c h a i
challenge	c h a l l e n g e
cham	c h a m
champa	c h a m p a
champagne	c h a m p a g n e
champions	c h a m p i o n s
chan	c h a n
chanda	c h a n d a
chanel	c h a n e l
chang	c h a n g
change	c h a n g e
chanh	c h a n h
chao	c h a o
chaplin	c h a p l i n
charles	c h a r l e s
charlie	c h a r l i e
charlize	c h a r l i z e
charlotte	c h a r l o t t e
charlton	c h a r l t o n
chat	c h a t
chau	c h a u
chavez	c h a v e z
chay	c h a y
che	c h e
check	c h e c k
cheeseburger	c h e e s e b u r g e r
chelsea	c h e l s e a
chem	c h e m
chen	c h e n
cheng	c h e n g
cheo	c h e o
chermarn	c h e r m a r n
cheryl	c h e r y l
chevy	c h e v y
chi	c h i
chi-hua-hua	c h i h u a h u a
chia	c h i a
chiang	c h i a n g
chiangmai	c h i a n g m a i
chicago	c h i c a g o
children	c h i l d r e n
chim	c h i m
chin	c h i n
china	c h i n a
chinatown	c h i n a t o w n
chinh	c h i n h
chiu	c h i u
chiêm	c h i ê m
chiên	c h i ê n
chiêng	c h i ê n g
chiêu	c h i ê u
chiếc	c h i ế c
chiếm	c h i ế m
chiến	c h i ế n
chiếng	c h i ế n g
chiếp	c h i ế p
chiết	c h i ế t
chiếu	c h i ế u
chiền	c h i ề n
chiềng	c h i ề n g
chiều	c h i ề u
chiển	c h i ể n
chiểu	c h i ể u
chiệc	c h i ệ c
chiện	c h i ệ n
cho	c h o
choa	c h o a
choai	c h o a i
choang	c h o a n g
chocolate	c h o c o l a t e
choe	c h o e
choen	c h o e n
choi	c h o i
choice	c h o i c e
cholesterol	c h o l e s t e r o l
chom	c h o m
chon	c h o n
chong	c h o n g
chopper	c h o p p e r
choài	c h o à i
choàm	c h o à m
choàng	c h o à n g
choá	c h o á
choác	c h o á c
choái	c h o á i
choán	c h o á n
choáng	c h o á n g
choãi	c h o ã i
choè	c h o è
choèn	c h o è n
choé	c h o é
choét	c h o é t
choòng	c h o ò n g
choăn	c h o ă n
choạc	c h o ạ c
choại	c h o ạ i
choạng	c h o ạ n g
choạp	c h o ạ p
choảng	c h o ả n g
choắt	c h o ắ t
choẹ	c h o ẹ
choẹt	c h o ẹ t
christina	c h r i s t i n a
christine	c h r i s t i n e
chrome	c h r o m e
chrysler	c h r y s l e r
chrystal	c h r y s t a l
chu	c h u
chu-ru	c h u r u
chua	c h u a
chui	c h u i
chum	c h u m
chun	c h u n
chung	c h u n g
chungcheongnam	c h u n g c h e o n g n a m
chuy	c h u y
chuyên	c h u y ê n
chuyến	c h u y ế n
chuyết	c h u y ế t
chuyền	c h u y ề n
chuyển	c h u y ể n
chuyện	c h u y ệ n
chuôi	c h u ô i
chuôm	c h u ô m
chuông	c h u ô n g
chuẩn	c h u ẩ n
chuế	c h u ế
chuếch	c h u ế c h
chuếnh	c h u ế n h
chuểnh	c h u ể n h
chuệch	c h u ệ c h
chuệnh	c h u ệ n h
chuốc	c h u ố c
chuối	c h u ố i
chuốt	c h u ố t
chuồi	c h u ồ i
chuồn	c h u ồ n
chuồng	c h u ồ n g
chuỗi	c h u ỗ i
chuộc	c h u ộ c
chuội	c h u ộ i
chuộng	c h u ộ n g
chuột	c h u ộ t
chuỳ	c h u ỳ
chà	c h à
chài	c h à i
chàm	c h à m
chàng	c h à n g
chành	c h à n h
chào	c h à o
chàu	c h à u
chày	c h à y
chá	c h á
chác	c h á c
chách	c h á c h
chái	c h á i
chán	c h á n
cháng	c h á n g
chánh	c h á n h
cháo	c h á o
chát	c h á t
cháu	c h á u
cháy	c h á y
châm	c h â m
chân	c h â n
châng	c h â n g
châu	c h â u
châu-ro	c h â u r o
chây	c h â y
chã	c h ã
chãi	c h ã i
chão	c h ã o
chè	c h è
chèm	c h è m
chèn	c h è n
chèo	c h è o
ché	c h é
chém	c h é m
chén	c h é n
chéng	c h é n g
chéo	c h é o
chép	c h é p
chét	c h é t
chê	c h ê
chêm	c h ê m
chênh	c h ê n h
chêu	c h ê u
chì	c h ì
chìa	c h ì a
chìm	c h ì m
chình	c h ì n h
chìu	c h ì u
chí	c h í
chí-phèo	c h í p h è o
chía	c h í a
chích	c h í c h
chím	c h í m
chín	c h í n
chính	c h í n h
chíp	c h í p
chít	c h í t
chíu	c h í u
chò	c h ò
chòe	c h ò e
chòi	c h ò i
chòm	c h ò m
chòng	c h ò n g
chó	c h ó
chóa	c h ó a
chóc	c h ó c
chóe	c h ó e
chói	c h ó i
chóng	c h ó n g
chóp	c h ó p
chót	c h ó t
chô	c h ô
chôm	c h ô m
chôn	c h ô n
chông	c h ô n g
chõ	c h õ
chõm	c h õ m
chõng	c h õ n g
chù	c h ù
chùa	c h ù a
chùi	c h ù i
chùm	c h ù m
chùn	c h ù n
chùng	c h ù n g
chùy	c h ù y
chú	c h ú
chúa	c h ú a
chúc	c h ú c
chúi	c h ú i
chúm	c h ú m
chúng	c h ú n g
chút	c h ú t
chúy	c h ú y
chăm	c h ă m
chăm-rê	c h ă m r ê
chăn	c h ă n
chăng	c h ă n g
chĩ	c h ĩ
chĩa	c h ĩ a
chĩn	c h ĩ n
chĩnh	c h ĩ n h
chĩu	c h ĩ u
chũi	c h ũ i
chũm	c h ũ m
chũn	c h ũ n
chơ	c h ơ
chơ-rai	c h ơ r a i
chơ-ro	c h ơ r o
chơ-ru	c h ơ r u
chơi	c h ơ i
chơm	c h ơ m
chơn	c h ơ n
chư	c h ư
chưa	c h ư a
chưa!	c h ư a !
chưn	c h ư n
chưng	c h ư n g
chưýên	c h ư ý ê n
chương	c h ư ơ n g
chương-đài	c h ư ơ n g đ à i
chước	c h ư ớ c
chướng	c h ư ớ n g
chườm	c h ư ờ m
chường	c h ư ờ n g
chưởi	c h ư ở i
chưởng	c h ư ở n g
chưỡng	c h ư ỡ n g
chược	c h ư ợ c
chượp	c h ư ợ p
chạ	c h ạ
chạc	c h ạ c
chạch	c h ạ c h
chạm	c h ạ m
chạn	c h ạ n
chạng	c h ạ n g
chạnh	c h ạ n h
chạo	c h ạ o
chạp	c h ạ p
chạt	c h ạ t
chạy	c h ạ y
chả	c h ả
chải	c h ả i
chảm	c h ả m
chảng	c h ả n g
chảnh	c h ả n h
chảo	c h ả o
chảu	c h ả u
chảy	c h ả y
chấm	c h ấ m
chấn	c h ấ n
chấp	c h ấ p
chất	c h ấ t
chấu	c h ấ u
chấy	c h ấ y
chầm	c h ầ m
chần	c h ầ n
chầu	c h ầ u
chầy	c h ầ y
chẩm	c h ẩ m
chẩn	c h ẩ n
chẩu	c h ẩ u
chẩy	c h ẩ y
chẫm	c h ẫ m
chẫn	c h ẫ n
chẫu	c h ẫ u
chậc	c h ậ c
chậm	c h ậ m
chận	c h ậ n
chập	c h ậ p
chật	c h ậ t
chậu	c h ậ u
chậy	c h ậ y
chắc	c h ắ c
chắm	c h ắ m
chắn	c h ắ n
chắp	c h ắ p
chắt	c h ắ t
chằm	c h ằ m
chằn	c h ằ n
chằng	c h ằ n g
chẳng	c h ẳ n g
chẵn	c h ẵ n
chẵng	c h ẵ n g
chặc	c h ặ c
chặm	c h ặ m
chặn	c h ặ n
chặng	c h ặ n g
chặp	c h ặ p
chặt	c h ặ t
chẹn	c h ẹ n
chẹo	c h ẹ o
chẹp	c h ẹ p
chẹt	c h ẹ t
chẻ	c h ẻ
chẻm	c h ẻ m
chẻn	c h ẻ n
chẻng	c h ẻ n g
chẻo	c h ẻ o
chẽ	c h ẽ
chẽm	c h ẽ m
chẽn	c h ẽ n
chẽo	c h ẽ o
chế	c h ế
chếch	c h ế c h
chếm	c h ế m
chếnh	c h ế n h
chếp	c h ế p
chết	c h ế t
chề	c h ề
chềm	c h ề m
chềnh	c h ề n h
chểnh	c h ể n h
chễm	c h ễ m
chễnh	c h ễ n h
chệ	c h ệ
chệch	c h ệ c h
chệm	c h ệ m
chện	c h ệ n
chệnh	c h ệ n h
chệp	c h ệ p
chệt	c h ệ t
chỉ	c h ỉ
chỉa	c h ỉ a
chỉn	c h ỉ n
chỉnh	c h ỉ n h
chị	c h ị
chịa	c h ị a
chịn	c h ị n
chịt	c h ị t
chịu	c h ị u
chọ	c h ọ
chọc	c h ọ c
chọe	c h ọ e
chọi	c h ọ i
chọn	c h ọ n
chọp	c h ọ p
chọt	c h ọ t
chỏ	c h ỏ
chỏi	c h ỏ i
chỏm	c h ỏ m
chỏn	c h ỏ n
chỏng	c h ỏ n g
chốc	c h ố c
chối	c h ố i
chốn	c h ố n
chống	c h ố n g
chốp	c h ố p
chốt	c h ố t
chồ	c h ồ
chồi	c h ồ i
chồm	c h ồ m
chồn	c h ồ n
chồng	c h ồ n g
chổ	c h ổ
chổi	c h ổ i
chổm	c h ổ m
chổng	c h ổ n g
chỗ	c h ỗ
chỗi	c h ỗ i
chỗm	c h ỗ m
chộ	c h ộ
chội	c h ộ i
chộn	c h ộ n
chộp	c h ộ p
chột	c h ộ t
chớ	c h ớ
chới	c h ớ i
chớm	c h ớ m
chớn	c h ớ n
chớp	c h ớ p
chớt	c h ớ t
chờ	c h ờ
chờm	c h ờ m
chờn	c h ờ n
chở	c h ở
chởm	c h ở m
chợ	c h ợ
chợi	c h ợ i
chợn	c h ợ n
chợp	c h ợ p
chợt	c h ợ t
chục	c h ụ c
chụm	c h ụ m
chụp	c h ụ p
chụt	c h ụ t
chủ	c h ủ
chủa	c h ủ a
chủm	c h ủ m
chủn	c h ủ n
chủng	c h ủ n g
chủy	c h ủ y
chứ	c h ứ
chứa	c h ứ a
chức	c h ứ c
chứng	c h ứ n g
chứt	c h ứ t
chừ	c h ừ
chừa	c h ừ a
chừng	c h ừ n g
chử	c h ử
chửa	c h ử a
chửi	c h ử i
chửng	c h ử n g
chữ	c h ữ
chữa	c h ữ a
chững	c h ữ n g
chực	c h ự c
chựng	c h ự n g
chựu	c h ự u
circus	c i r c u s
cisco	c i s c o
citroen	c i t r o e n
city	c i t y
civic	c i v i c
claremont	c l a r e m o n t
clarinet	c l a r i n e t
class	c l a s s
classmate	c l a s s m a t e
claymore	c l a y m o r e
clean	c l e a n
clear	c l e a r
clement	c l e m e n t
click	c l i c k
clinton	c l i n t o n
clip	c l i p
close	c l o s e
club	c l u b
cluj	c l u j
cm	c m
co	c o
co-ban	c o b a n
co-lo-phan	c o l o p h a n
co-sin	c o s i n
co-tang	c o t a n g
coast	c o a s t
coca	c o c a
cocacola	c o c a c o l a
cocktail	c o c k t a i l
code	c o d e
coffee	c o f f e e
coffman	c o f f m a n
coi	c o i
cold	c o l d
cole	c o l e
coleen	c o l e e n
coleman	c o l e m a n
college	c o l l e g e
cologne	c o l o g n e
colombia	c o l o m b i a
colombo	c o l o m b o
com	c o m
com-bi-ne-dông	c o m b i n e d ô n g
com-bin	c o m b i n
com-bờ-lê	c o m b ờ l ê
com-lê	c o m l ê
com-mi	c o m m i
com-mít-xi-ông	c o m m í t x i ô n g
com-măng	c o m m ă n g
com-măng-ca	c o m m ă n g c a
com-măng-đô	c o m m ă n g đ ô
com-mốt	c o m m ố t
com-pa	c o m p a
com-pa-nhi	c o m p a n h i
com-pu-tơ	c o m p u t ơ
com-pô	c o m p ô
com-pô-dít	c o m p ô d í t
com-pắc	c o m p ắ c
common	c o m m o n
computer	c o m p u t e r
computing	c o m p u t i n g
con	c o n
con-léc-xi-ông	c o n l é c x i ô n g
condom	c o n d o m
confirm	c o n f i r m
cong	c o n g
cong-tờ-gút	c o n g t ờ g ú t
connect	c o n n e c t
connor	c o n n o r
console	c o n s o l e
contacts	c o n t a c t s
container	c o n t a i n e r
cookie	c o o k i e
cool	c o o l
coong	c o o n g
cop	c o p
copenhagen	c o p e n h a g e n
copy	c o p y
corp	c o r p
cos	c o s
costa	c o s t a
cot	c o t
cota	c o t a
countries	c o u n t r i e s
country	c o u n t r y
coup	c o u p
coupe	c o u p e
couper	c o u p e r
couture	c o u t u r e
cover	c o v e r
coóc	c o ó c
coóc-nê	c o ó c n ê
coóc-ti-don	c o ó c t i d o n
coóc-ti-dôn	c o ó c t i d ô n
coóc-xê	c o ó c x ê
coọc	c o ọ c
crack	c r a c k
craddock	c r a d d o c k
craigie	c r a i g i e
cricket	c r i c k e t
croatia	c r o a t i a
crouch	c r o u c h
crowell	c r o w e l l
cruise	c r u i s e
cruze	c r u z e
cry	c r y
cs	c s
cu	c u
cu-li	c u l i
cu-lit	c u l i t
cu-lít	c u l í t
cu-lông	c u l ô n g
cu-pông	c u p ô n g
cu-roa	c u r o a
cu-ron	c u r o n
cu-soong	c u s o o n g
cua	c u a
cua-roa	c u a r o a
cua-ron	c u a r o n
cua-rơ	c u a r ơ
cuba	c u b a
cui	c u i
cullen	c u l l e n
cum	c u m
cun	c u n
cung	c u n g
cup	c u p
customize	c u s t o m i z e
cuôc	c u ô c
cuông	c u ô n g
cuốc	c u ố c
cuối	c u ố i
cuốn	c u ố n
cuống	c u ố n g
cuồn	c u ồ n
cuồng	c u ồ n g
cuỗm	c u ỗ m
cuộc	c u ộ c
cuội	c u ộ i
cuộn	c u ộ n
cuộng	c u ộ n g
cuờng	c u ờ n g
cx	c x
cy	c y
cyrus	c y r u s
cà	c à
cà-mèn	c à m è n
cà-phê	c à p h ê
cà-rem	c à r e m
cà-ri	c à r i
cà-rốt	c à r ố t
cà-vạt	c à v ạ t
cài	c à i
càm	c à m
càn	c à n
càng	c à n g
càng...	c à n g . . .
cành	c à n h
cào	c à o
càu	c à u
cày	c à y
cá	c á
các	c á c
các-bin	c á c b i n
các-bo-nát	c á c b o n á t
các-bon	c á c b o n
các-bon-nic	c á c b o n n i c
các-bon-nát	c á c b o n n á t
các-bon-ních	c á c b o n n í c h
các-bua	c á c b u a
các-ten	c á c t e n
các-táp	c á c t á p
các-tông	c á c t ô n g
các-tơ	c á c t ơ
các-vi-dít	c á c v i d í t
cách	c á c h
cái	c á i
cám	c á m
cán	c á n
cáng	c á n g
cánh	c á n h
cáo	c á o
cáp	c á p
cát	c á t
cát-két	c á t k é t
cát-mi	c á t m i
cát-sê	c á t s ê
cát-xét	c á t x é t
cát-xê	c á t x ê
cáu	c á u
cáy	c á y
câm	c â m
cân	c â n
câng	c â n g
câu	c â u
câu-rút	c â u r ú t
cây	c â y
câù	c â ù
cãi	c ã i
cãm	c ã m
cò	c ò
cò-mi	c ò m i
còi	c ò i
còm	c ò m
còm-mi	c ò m m i
còn	c ò n
còng	c ò n g
có	c ó
cóc	c ó c
cói	c ó i
cóm	c ó m
cón	c ó n
cóng	c ó n g
cóp	c ó p
cót	c ó t
cô	c ô
cô-	c ô
cô-ban	c ô b a n
cô-ca	c ô c a
cô-ca-in	c ô c a i n
cô-le	c ô l e
cô-li	c ô l i
cô-lô-nhần	c ô l ô n h ầ n
cô-lô-phan	c ô l ô p h a n
cô-lôn	c ô l ô n
cô-nhắc	c ô n h ắ c
cô-pếch	c ô p ế c h
cô-sin	c ô s i n
cô-sông	c ô s ô n g
cô-ta	c ô t a
cô-tang	c ô t a n g
cô-ti-dê	c ô t i d ê
cô-tông	c ô t ô n g
cô-ve	c ô v e
cô-đê	c ô đ ê
cô-đê-in	c ô đ ê i n
côca	c ô c a
côi	c ô i
côla	c ô l a
côm	c ô m
côn	c ô n
công	c ô n g
công-bát	c ô n g b á t
công-bạt	c ô n g b ạ t
công-cua	c ô n g c u a
công-pho	c ô n g p h o
công-phét-ti	c ô n g p h é t t i
công-quy-răng	c ô n g q u y r ă n g
công-ta	c ô n g t a
công-te-nơ	c ô n g t e n ơ
công-toa	c ô n g t o a
công-tôn	c ô n g t ô n
công-tơ	c ô n g t ơ
công-tơ-rơ-bát	c ô n g t ơ r ơ b á t
công-tắc	c ô n g t ắ c
công-voa	c ô n g v o a
công-xi	c ô n g x i
công-xinh	c ô n g x i n h
công-xon	c ô n g x o n
công-xoóc-xi-om	c ô n g x o ó c x i o m
công-xây	c ô n g x â y
công-xéc-tô	c ô n g x é c t ô
công-xôn	c ô n g x ô n
côống	c ô ố n g
cõi	c õ i
cõm	c õ m
cõng	c õ n g
cù	c ù
cùa	c ù a
cùi	c ù i
cùi-dìa	c ù i d ì a
cùm	c ù m
cùn	c ù n
cùng	c ù n g
cú	c ú
cúa	c ú a
cúc	c ú c
cúi	c ú i
cúm	c ú m
cún	c ú n
cúng	c ú n g
cúp	c ú p
cút	c ú t
cút-lít	c ú t l í t
căm	c ă m
căn	c ă n
căn-tin	c ă n t i n
căng	c ă n g
căng-tin	c ă n g t i n
cũ	c ũ
cũi	c ũ i
cũn	c ũ n
cũng	c ũ n g
cơ	c ơ
cơ-don	c ơ d o n
cơ-ho	c ơ h o
cơ-lanh-ke	c ơ l a n h k e
cơ-lê	c ơ l ê
cơ-rôn	c ơ r ô n
cơ-tu	c ơ t u
cơi	c ơ i
cơm	c ơ m
cơn	c ơ n
cư	c ư
cưa	c ư a
cưng	c ư n g
cưu	c ư u
cương	c ư ơ n g
cước	c ư ớ c
cưới	c ư ớ i
cướp	c ư ớ p
cười	c ư ờ i
cườm	c ư ờ m
cường	c ư ờ n g
cưỡi	c ư ỡ i
cưỡng	c ư ỡ n g
cược	c ư ợ c
cượp	c ư ợ p
cạ	c ạ
cạc	c ạ c
cạch	c ạ c h
cạm	c ạ m
cạn	c ạ n
cạnh	c ạ n h
cạo	c ạ o
cạp	c ạ p
cạu	c ạ u
cạy	c ạ y
cả	c ả
cải	c ả i
cảm	c ả m
cản	c ả n
cảng	c ả n g
cảnh	c ả n h
cảo	c ả o
cảu	c ả u
cảy	c ả y
cấc	c ấ c
cấm	c ấ m
cấn	c ấ n
cấp	c ấ p
cất	c ấ t
cấu	c ấ u
cấy	c ấ y
cầm	c ầ m
cần	c ầ n
cầu	c ầ u
cầy	c ầ y
cẩm	c ẩ m
cẩn	c ẩ n
cẩu	c ẩ u
cẩy	c ẩ y
cẫm	c ẫ m
cẫn	c ẫ n
cẫng	c ẫ n g
cậm	c ậ m
cận	c ậ n
cập	c ậ p
cật	c ậ t
cậu	c ậ u
cậy	c ậ y
cắc	c ắ c
cắc-tê	c ắ c t ê
cắm	c ắ m
cắn	c ắ n
cắng	c ắ n g
cắp	c ắ p
cắt	c ắ t
cằm	c ằ m
cằn	c ằ n
cẳn	c ẳ n
cẳng	c ẳ n g
cẵng	c ẵ n g
cặc	c ặ c
cặm	c ặ m
cặn	c ặ n
cặp	c ặ p
cặt	c ặ t
cọ	c ọ
cọc	c ọ c
cọi	c ọ i
cọm	c ọ m
cọn	c ọ n
cọng	c ọ n g
cọp	c ọ p
cọp-dê	c ọ p d ê
cọt	c ọ t
cỏ	c ỏ
cỏ-vê	c ỏ v ê
cỏi	c ỏ i
cỏm	c ỏ m
cỏn	c ỏ n
cỏng	c ỏ n g
cố	c ố
cốc	c ố c
cốc-tai	c ố c t a i
cốc-tay	c ố c t a y
cối	c ố i
cốm	c ố m
cốn	c ố n
cống	c ố n g
cốp	c ố p
cốp-pha	c ố p p h a
cốt	c ố t
cốt-lét	c ố t l é t
cốt-nhát	c ố t n h á t
cốt-nhắc	c ố t n h ắ c
cốt-pha	c ố t p h a
cốt-phát	c ố t p h á t
cồ	c ồ
cồm	c ồ m
cồn	c ồ n
cồng	c ồ n g
cổ	c ổ
cổ-dề	c ổ d ề
cổi	c ổ i
cổn	c ổ n
cổng	c ổ n g
cỗ	c ỗ
cỗi	c ỗ i
cộ	c ộ
cộc	c ộ c
cội	c ộ i
cộm	c ộ m
cộn	c ộ n
cộng	c ộ n g
cộp	c ộ p
cột	c ộ t
cớ	c ớ
cớm	c ớ m
cớn	c ớ n
cớt	c ớ t
cờ	c ờ
cờ-lê	c ờ l ê
cờ-lếp	c ờ l ế p
cờ-ra-vát	c ờ r a v á t
cờ-rếp	c ờ r ế p
cời	c ờ i
cờn	c ờ n
cở	c ở
cởi	c ở i
cỡ	c ỡ
cỡi	c ỡ i
cỡm	c ỡ m
cỡn	c ỡ n
cợm	c ợ m
cợn	c ợ n
cợp	c ợ p
cợt	c ợ t
cụ	c ụ
cục	c ụ c
cụi	c ụ i
cụm	c ụ m
cụng	c ụ n g
cụp	c ụ p
cụt	c ụ t
củ	c ủ
của	c ủ a
củanh	c ủ a n h
củi	c ủ i
củm	c ủ m
củn	c ủ n
củng	c ủ n g
cứ	c ứ
cứa	c ứ a
cức	c ứ c
cứng	c ứ n g
cứt	c ứ t
cứu	c ứ u
cừ	c ừ
cừu	c ừ u
cử	c ử
cửa	c ử a
cửi	c ử i
cửng	c ử n g
cửu	c ử u
cữ	c ữ
cữu	c ữ u
cự	c ự
cựa	c ự a
cực	c ự c
cựu	c ự u
d	d
da	d a
dae	d a e
dai	d a i
daily	d a i l y
daki	d a k i
dam	d a m
damper	d a m p e r
dan	d a n
dang	d a n g
danh	d a n h
danie	d a n i e
danielle	d a n i e l l e
dante	d a n t e
danube	d a n u b e
dao	d a o
darling	d a r l i n g
darvo	d a r v o
data	d a t a
dave	d a v e
david	d a v i d
davids	d a v i d s
dawn	d a w n
day	d a y
dc	d c
de	d e
dean	d e a n
dear	d e a r
decor	d e c o r
defender	d e f e n d e r
defense	d e f e n s e
del	d e l
delete	d e l e t e
dell	d e l l
delta	d e l t a
demarco	d e m a r c o
demo	d e m o
den	d e n
deo	d e o
deposit	d e p o s i t
depp	d e p p
derby	d e r b y
detroit	d e t r o i t
device	d e v i c e
dhabit	d h a b i t
di	d i
di-đà	d i đ à
diablo	d i a b l o
diagnostic	d i a g n o s t i c
diamond	d i a m o n d
diaz	d i a z
did	d i d
die	d i e
diego	d i e g o
diesel	d i e s e l
dim	d i m
din	d i n
diners	d i n e r s
dinh	d i n h
dinh-tê	d i n h t ê
disable	d i s a b l e
disneyland	d i s n e y l a n d
diu	d i u
diva	d i v a
diêm	d i ê m
diêm-vương	d i ê m v ư ơ n g
diên	d i ê n
diêu	d i ê u
diếc	d i ế c
diến	d i ế n
diếp	d i ế p
diết	d i ế t
diếu	d i ế u
diềm	d i ề m
diềng	d i ề n g
diều	d i ề u
diểu	d i ể u
diễm	d i ễ m
diễn	d i ễ n
diễu	d i ễ u
diệc	d i ệ c
diệm	d i ệ m
diện	d i ệ n
diệp	d i ệ p
diệt	d i ệ t
diệu	d i ệ u
dmax	d m a x
dna	d n a
do	d o
doa	d o a
doan	d o a n
doanh	d o a n h
dobkin	d o b k i n
doc	d o c
dock	d o c k
dodger	d o d g e r
dog	d o g
dogs	d o g s
doha	d o h a
doi	d o i
dollar	d o l l a r
dom	d o m
domenech	d o m e n e c h
don	d o n
done	d o n e
dong	d o n g
dongyu	d o n g y u
donovan	d o n o v a n
dorn	d o r n
dorothy	d o r o t h y
dot	d o t
dover	d o v e r
down	d o w n
download	d o w n l o a d
doàng	d o à n g
doành	d o à n h
doá	d o á
doãi	d o ã i
doãn	d o ã n
doãng	d o ã n g
doạ	d o ạ
doạng	d o ạ n g
drama	d r a m a
dream	d r e a m
drive	d r i v e
driver	d r i v e r
dslr	d s l r
du	d u
dua	d u a
dubai	d u b a i
dudek	d u d e k
dukoni	d u k o n i
dun	d u n
dung	d u n g
duy	d u y
duyên	d u y ê n
duyến	d u y ế n
duyện	d u y ệ n
duyệt	d u y ệ t
duôi	d u ô i
duẩn	d u ẩ n
duẫn	d u ẫ n
duật	d u ậ t
duềnh	d u ề n h
duệ	d u ệ
duốc	d u ố c
duối	d u ố i
duồn	d u ồ n
duỗi	d u ỗ i
duộc	d u ộ c
dwight	d w i g h t
dy	d y
dyn	d y n
dynamic	d y n a m i c
dynamo	d y n a m o
dà	d à
dài	d à i
dàm	d à m
dàn	d à n
dàng	d à n g
dành	d à n h
dào	d à o
dàu	d à u
dày	d à y
dá	d á
dác	d á c
dách	d á c h
dái	d á i
dám	d á m
dán	d á n
dáng	d á n g
dáo	d á o
dát	d á t
dáu	d á u
dáy	d á y
dâm	d â m
dân	d â n
dâng	d â n g
dâu	d â u
dây	d â y
dã	d ã
dãi	d ã i
dãn	d ã n
dãng	d ã n g
dãy	d ã y
dè	d è
dèn	d è n
dé	d é
dém	d é m
déo	d é o
dép	d é p
dê	d ê
dê-rô	d ê r ô
dên	d ê n
dênh	d ê n h
dì	d ì
dìa	d ì a
dìm	d ì m
dìu	d ì u
dí	d í
dích	d í c h
dích-dắc	d í c h d ắ c
dích-lơ	d í c h l ơ
dím	d í m
dính	d í n h
díp	d í p
díu	d í u
dò	d ò
dòi	d ò i
dòm	d ò m
dòng	d ò n g
dó	d ó
dóa	d ó a
dóc	d ó c
dói	d ó i
dóm	d ó m
dón	d ó n
dóng	d ó n g
dót	d ó t
dô	d ô
dô-kề	d ô k ề
dôi	d ô i
dông	d ô n g
dõi	d õ i
dõng	d õ n g
dù	d ù
dùa	d ù a
dùi	d ù i
dùm	d ù m
dùn	d ù n
dùng	d ù n g
dúa	d ú a
dúi	d ú i
dúm	d ú m
dún	d ú n
dúng	d ú n g
dút	d ú t
dýn	d ý n
dăm	d ă m
dăn	d ă n
dăng	d ă n g
dĩ	d ĩ
dĩa	d ĩ a
dĩn	d ĩ n
dĩnh	d ĩ n h
dũ	d ũ
dũa	d ũ a
dũi	d ũ i
dũng	d ũ n g
dơ	d ơ
dơi	d ơ i
dơn	d ơ n
dư	d ư
dưa	d ư a
dưng	d ư n g
dương	d ư ơ n g
dưới	d ư ớ i
dướn	d ư ớ n
dướng	d ư ớ n g
dường	d ư ờ n g
dưỡng	d ư ỡ n g
dược	d ư ợ c
dượi	d ư ợ i
dượng	d ư ợ n g
dượt	d ư ợ t
dạ	d ạ
dạ-xoa	d ạ x o a
dạc	d ạ c
dại	d ạ i
dạm	d ạ m
dạn	d ạ n
dạng	d ạ n g
dạo	d ạ o
dạt	d ạ t
dạy	d ạ y
dả	d ả
dải	d ả i
dảm	d ả m
dảnh	d ả n h
dảy	d ả y
dấm	d ấ m
dấn	d ấ n
dấp	d ấ p
dấu	d ấ u
dấy	d ấ y
dầm	d ầ m
dần	d ầ n
dầu	d ầ u
dầy	d ầ y
dẩm	d ẩ m
dẩn	d ẩ n
dẩu	d ẩ u
dẩy	d ẩ y
dẫm	d ẫ m
dẫn	d ẫ n
dẫu	d ẫ u
dẫy	d ẫ y
dậm	d ậ m
dận	d ậ n
dập	d ậ p
dật	d ậ t
dậu	d ậ u
dậy	d ậ y
dắc	d ắ c
dắm	d ắ m
dắng	d ắ n g
dắt	d ắ t
dằm	d ằ m
dằn	d ằ n
dằng	d ằ n g
dẳn	d ẳ n
dẳng	d ẳ n g
dặc	d ặ c
dặm	d ặ m
dặn	d ặ n
dặng	d ặ n g
dặt	d ặ t
dẹm	d ẹ m
dẹo	d ẹ o
dẹp	d ẹ p
dẹt	d ẹ t
dẻ	d ẻ
dẻo	d ẻ o
dẽ	d ẽ
dế	d ế
dếch	d ế c h
dết	d ế t
dề	d ề
dền	d ề n
dềnh	d ề n h
dể	d ể
dễ	d ễ
dệ	d ệ
dệch	d ệ c h
dện	d ệ n
dệnh	d ệ n h
dệt	d ệ t
dệu	d ệ u
dỉ	d ỉ
dị	d ị
dịch	d ị c h
dịp	d ị p
dịt	d ị t
dịu	d ị u
dọ	d ọ
dọa	d ọ a
dọc	d ọ c
dọi	d ọ i
dọn	d ọ n
dọng	d ọ n g
dọp	d ọ p
dỏ	d ỏ
dỏm	d ỏ m
dỏng	d ỏ n g
dốc	d ố c
dối	d ố i
dống	d ố n g
dốt	d ố t
dồ	d ồ
dồi	d ồ i
dồn	d ồ n
dồng	d ồ n g
dổi	d ổ i
dổm	d ổ m
dỗ	d ỗ
dỗi	d ỗ i
dộc	d ộ c
dội	d ộ i
dộng	d ộ n g
dộp	d ộ p
dột	d ộ t
dớ	d ớ
dới	d ớ i
dớn	d ớ n
dớp	d ớ p
dờ	d ờ
dời	d ờ i
dờn	d ờ n
dở	d ở
dởm	d ở m
dỡ	d ỡ
dợ	d ợ
dợm	d ợ m
dợn	d ợ n
dụ	d ụ
dụa	d ụ a
dục	d ụ c
dụi	d ụ i
dụm	d ụ m
dụng	d ụ n g
dụt	d ụ t
dụy	d ụ y
dủi	d ủ i
dứ	d ứ
dứa	d ứ a
dức	d ứ c
dứng	d ứ n g
dứt	d ứ t
dứu	d ứ u
dừ	d ừ
dừa	d ừ a
dừng	d ừ n g
dử	d ử
dửng	d ử n g
dửu	d ử u
dữ	d ữ
dữu	d ữ u
dự	d ự
dựa	d ự a
dực	d ự c
dựng	d ự n g
dựt	d ự t
dựu	d ự u
e	e
e-bo-nít	e b o n í t
e-léc-tron	e l é c t r o n
e-lêc-tơ-ron	e l ê c t ơ r o n
e-líp	e l í p
e-me-tin	e m e t i n
e-mê-tin	e m ê t i n
e-ti-len	e t i l e n
e-xen-đô	e x e n đ ô
eco	e c o
economic	e c o n o m i c
economy	e c o n o m y
eddie	e d d i e
edinburgh	e d i n b u r g h
edith	e d i t h
edward	e d w a r d
effective	e f f e c t i v e
eh	e h
eisenhower	e i s e n h o w e r
el	e l
elias	e l i a s
elite	e l i t e
elizabeth	e l i z a b e t h
ellery	e l l e r y
elly	e l l y
elmham	e l m h a m
elton	e l t o n
em	e m
em-mê	e m m ê
email	e m a i l
emm	e m m
emma	e m m a
emu	e m u
en	e n
en-dim	e n d i m
en-líp	e n l í p
en-tro-pi	e n t r o p i
en-tơ-ro-pi	e n t ơ r o p i
enclave	e n c l a v e
encrypt	e n c r y p t
ended	e n d e d
endorphin	e n d o r p h i n
enemies	e n e m i e s
eng	e n g
ensure	e n s u r e
enzo	e n z o
eo	e o
eric	e r i c
erik	e r i k
es	e s
escape	e s c a p e
essentially	e s s e n t i a l l y
esteben	e s t e b e n
estee	e s t e e
esteem	e s t e e m
estella	e s t e l l a
ethernet	e t h e r n e t
eto	e t o
euro	e u r o
europass	e u r o p a s s
eurostar	e u r o s t a r
eva	e v a
evan	e v a n
evans	e v a n s
eve	e v e
event	e v e n t
ever	e v e r
evn	e v n
evolution	e v o l u t i o n
excel	e x c e l
exchange	e x c h a n g e
exciter	e x c i t e r
export	e x p o r t
exporting	e x p o r t i n g
express	e x p r e s s
f	f
fa	f a
facebook	f a c e b o o k
facts	f a c t s
fair	f a i r
fairmont	f a i r m o n t
fake	f a k e
fan	f a n
fans	f a n s
fansipan	f a n s i p a n
fantom	f a n t o m
fashion	f a s h i o n
fast	f a s t
fax	f a x
fe	f e
federer	f e d e r e r
feeling	f e e l i n g
feet	f e e t
felt	f e l t
fenn	f e n n
fenton	f e n t o n
ferdinand	f e r d i n a n d
ferguson	f e r g u s o n
fergusson	f e r g u s s o n
ferrari	f e r r a r i
ferrer	f e r r e r
fertile	f e r t i l e
fi	f i
fiat	f i a t
fifa	f i f a
fifth	f i f t h
fil	f i l
file	f i l e
files	f i l e s
film	f i l m
filo	f i l o
finance	f i n a n c e
finder	f i n d e r
firefox	f i r e f o x
first	f i r s t
fish	f i s h
fishermen	f i s h e r m e n
fix	f i x
flame	f l a m e
flanders	f l a n d e r s
flash	f l a s h
florentino	f l o r e n t i n o
florida	f l o r i d a
floyd	f l o y d
fly	f l y
fone	f o n e
for	f o r
force	f o r c e
ford	f o r d
foreman	f o r e m a n
forest	f o r e s t
format	f o r m a t
forte	f o r t e
forum	f o r u m
fp	f p
frame	f r a m e
france	f r a n c e
francisco	f r a n c i s c o
frank	f r a n k
frankfurt	f r a n k f u r t
frazier	f r a z i e r
freedom	f r e e d o m
fsoft	f s o f t
fujitv	f u j i t v
full	f u l l
fun	f u n
fund	f u n d
funky	f u n k y
funès	f u n è s
ga	g a
ga-ba-đin	g a b a đ i n
ga-bác-đin	g a b á c đ i n
ga-la	g a l a
ga-len	g a l e n
ga-li	g a l i
ga-lon	g a l o n
ga-lông	g a l ô n g
ga-lăng	g a l ă n g
ga-lơ-ri	g a l ơ r i
ga-ma	g a m a
ga-men	g a m e n
ga-ra	g a r a
ga-rô	g a r ô
ga-răng-ti	g a r ă n g t i
ga-tuýt	g a t u ý t
ga-tô	g a t ô
gaal	g a a l
gabriel	g a b r i e l
gadhafi	g a d h a f i
gaga	g a g a
gai	g a i
gallon	g a l l o n
gam	g a m
gam-ma	g a m m a
game	g a m e
games	g a m e s
gan	g a n
gang	g a n g
ganh	g a n h
gao	g a o
gara	g a r a
garage	g a r a g e
garay	g a r a y
garden	g a r d e n
garu	g a r u
gas	g a s
gates	g a t e s
gatorade	g a t o r a d e
gattuso	g a t t u s o
gau	g a u
gautier	g a u t i e r
gay	g a y
gazprom	g a z p r o m
gcb	g c b
gdp	g d p
ge	g e
ge-la-tin	g e l a t i n
ge-ma-ni	g e m a n i
gehos	g e h o s
gel	g e l
gelfand	g e l f a n d
gemma	g e m m a
gen	g e n
general	g e n e r a l
geneva	g e n e v a
genève	g e n è v e
george	g e o r g e
geos	g e o s
german	g e r m a n
get	g e t
ghe	g h e
ghem	g h e m
ghen	g h e n
ghi	g h i
ghi-sê	g h i s ê
ghi-ta	g h i t a
ghi-đông	g h i đ ô n g
ghim	g h i m
ghin-de	g h i n d e
ghiếc	g h i ế c
ghiền	g h i ề n
ghè	g h è
ghèn	g h è n
ghé	g h é
ghém	g h é m
ghép	g h é p
ghét	g h é t
ghê	g h ê
ghì	g h ì
ghìm	g h ì m
ghình	g h ì n h
ghí	g h í
ghín	g h í n
ghính	g h í n h
ghít	g h í t
ghẹ	g h ẹ
ghẹn	g h ẹ n
ghẹo	g h ẹ o
ghẻ	g h ẻ
ghẽ	g h ẽ
ghế	g h ế
ghếch	g h ế c h
ghề	g h ề
ghềnh	g h ề n h
ghểnh	g h ể n h
ghễnh	g h ễ n h
ghệch	g h ệ c h
ghệt	g h ệ t
ghịt	g h ị t
gi	g i
gi-lê	g i l ê
gia	g i a
gia-két	g i a k é t
gia-rai	g i a r a i
gia-ven	g i a v e n
giai	g i a i
giam	g i a m
gian	g i a n
giang	g i a n g
gianh	g i a n h
giao	g i a o
giau	g i a u
gic-lơ	g i c l ơ
gie	g i e
gien	g i e n
gieo	g i e o
giggs	g i g g s
gihao	g i h a o
gilly	g i l l y
gin	g i n
gina	g i n a
ginny	g i n n y
ginza	g i n z a
gio	g i o
gioi	g i o i
gion	g i o n
giong	g i o n g
gioong	g i o o n g
gioàng	g i o à n g
gioăng	g i o ă n g
gip	g i p
girl	g i r l
giu	g i u
giu-đô	g i u đ ô
giua	g i u a
giun	g i u n
giuộc	g i u ộ c
già	g i à
giàm	g i à m
giàn	g i à n
giàng	g i à n g
giành	g i à n h
giào	g i à o
giàu	g i à u
giày	g i à y
giá	g i á
giác	g i á c
giái	g i á i
giám	g i á m
gián	g i á n
giáng	g i á n g
giáo	g i á o
giáp	g i á p
giát	g i á t
giáy	g i á y
giâm	g i â m
giâu	g i â u
giây	g i â y
giã	g i ã
giãi	g i ã i
giãm	g i ã m
giãn	g i ã n
giãy	g i ã y
gièm	g i è m
gié	g i é
giéo	g i é o
giê	g i ê
giêng	g i ê n g
giò	g i ò
giòi	g i ò i
giòn	g i ò n
gió	g i ó
gióc	g i ó c
giói	g i ó i
gión	g i ó n
gióng	g i ó n g
giô	g i ô
giôn	g i ô n
giông	g i ô n g
giùi	g i ù i
giùm	g i ù m
giú	g i ú
giúi	g i ú i
giúp	g i ú p
giăm	g i ă m
giăm-bông	g i ă m b ô n g
giăng	g i ă n g
giũ	g i ũ
giũa	g i ũ a
giơ	g i ơ
giơ-lâng	g i ơ l â n g
giơ-lơng	g i ơ l ơ n g
giơ-tông	g i ơ t ô n g
giương	g i ư ơ n g
giướng	g i ư ớ n g
giường	g i ư ờ n g
giượng	g i ư ợ n g
giạ	g i ạ
giạc	g i ạ c
giại	g i ạ i
giạm	g i ạ m
giạng	g i ạ n g
giạp	g i ạ p
giạt	g i ạ t
giả	g i ả
giải	g i ả i
giảm	g i ả m
giản	g i ả n
giảng	g i ả n g
giảnh	g i ả n h
giảo	g i ả o
giảu	g i ả u
giấc	g i ấ c
giấm	g i ấ m
giấn	g i ấ n
giấp	g i ấ p
giất	g i ấ t
giấu	g i ấ u
giấy	g i ấ y
giầm	g i ầ m
giần	g i ầ n
giầu	g i ầ u
giầy	g i ầ y
giẫm	g i ẫ m
giẫy	g i ẫ y
giậm	g i ậ m
giận	g i ậ n
giập	g i ậ p
giật	g i ậ t
giậu	g i ậ u
giắc	g i ắ c
giắm	g i ắ m
giắn	g i ắ n
giắng	g i ắ n g
giắt	g i ắ t
giằm	g i ằ m
giằn	g i ằ n
giằng	g i ằ n g
giẳn	g i ẳ n
giẵm	g i ẵ m
giặc	g i ặ c
giặm	g i ặ m
giặn	g i ặ n
giặt	g i ặ t
giẹo	g i ẹ o
giẹp	g i ẹ p
giẻ	g i ẻ
giẻ-triêng	g i ẻ t r i ê n g
giếc	g i ế c
giếm	g i ế m
giếng	g i ế n g
giết	g i ế t
giếu	g i ế u
giề	g i ề
giền	g i ề n
giềng	g i ề n g
giễu	g i ễ u
giọ	g i ọ
giọc	g i ọ c
giọi	g i ọ i
giọng	g i ọ n g
giọt	g i ọ t
giỏ	g i ỏ
giỏi	g i ỏ i
giỏn	g i ỏ n
giỏng	g i ỏ n g
giốc	g i ố c
giối	g i ố i
giống	g i ố n g
giốt	g i ố t
giồ	g i ồ
giồi	g i ồ i
giồng	g i ồ n g
giổi	g i ổ i
giỗ	g i ỗ
giỗi	g i ỗ i
giộ	g i ộ
giội	g i ộ i
giộp	g i ộ p
giớ	g i ớ
giới	g i ớ i
giờ	g i ờ
giời	g i ờ i
giờn	g i ờ n
giở	g i ở
giởi	g i ở i
giỡn	g i ỡ n
giụa	g i ụ a
giục	g i ụ c
giụi	g i ụ i
giủi	g i ủ i
giừ	g i ừ
giữ	g i ữ
giữa	g i ữ a
giựt	g i ự t
glasgow	g l a s g o w
glenfiddich	g l e n f i d d i c h
glow	g l o w
gmx	g m x
go	g o
go-tích	g o t í c h
godin	g o d i n
golf	g o l f
gom	g o m
gomez	g o m e z
gon	g o n
good	g o o d
goodison	g o o d i s o n
google	g o o g l e
goong	g o o n g
goto	g o t o
gout	g o u t
goá	g o á
goòng	g o ò n g
goóc	g o ó c
gr	g r
grafton	g r a f t o n
grand	g r a n d
grandis	g r a n d i s
great	g r e a t
green	g r e e n
greg	g r e g
gregan	g r e g a n
group	g r o u p
gruzia	g r u z i a
gu	g u
gu-giông	g u g i ô n g
guardiola	g u a r d i o l a
guest	g u e s t
gugu	g u g u
guitar	g u i t a r
gulliver	g u l l i v e r
gun	g u n
guti	g u t i
guốc	g u ố c
guồi	g u ồ i
guồng	g u ồ n g
guổng	g u ổ n g
guộc	g u ộ c
guộn	g u ộ n
guột	g u ộ t
gà	g à
gà-mèn	g à m è n
gài	g à i
gàn	g à n
gàng	g à n g
gành	g à n h
gào	g à o
gàu	g à u
gày	g à y
gá	g á
gác	g á c
gác-dan	g á c d a n
gác-dang	g á c d a n g
gác-măng-dê	g á c m ă n g d ê
gác-xon-nê	g á c x o n n ê
gác-đa-vu	g á c đ a v u
gác-điêng	g á c đ i ê n g
gác-đê-nan	g á c đ ê n a n
gác-đờ-bu	g á c đ ờ b u
gác-đờ-co	g á c đ ờ c o
gác-đờ-sen	g á c đ ờ s e n
gách	g á c h
gái	g á i
gán	g á n
gánh	g á n h
gáo	g á o
gáp	g á p
gáu	g á u
gáy	g á y
gâm	g â m
gân	g â n
gâu	g â u
gây	g â y
gã	g ã
gãi	g ã i
gãy	g ã y
gì	g ì
gìa	g ì a
gìm	g ì m
gìn	g ì n
gí	g í
gích	g í c h
gíp	g í p
gò	g ò
gòi	g ò i
gòn	g ò n
gòn-gia	g ò n g i a
góa	g ó a
góc	g ó c
gói	g ó i
góp	g ó p
gót	g ó t
gô	g ô
gô-ri	g ô r i
gô-ri-la	g ô r i l a
gô-tích	g ô t í c h
gô-đê	g ô đ ê
gôm	g ô m
gôn	g ô n
gông	g ô n g
gõ	g õ
gù	g ù
gùa	g ù a
gùi	g ù i
gùn	g ù n
gùng	g ù n g
gú	g ú
gúa	g ú a
gút	g ú t
găm	g ă m
găn	g ă n
găng	g ă n g
găng-tơ	g ă n g t ơ
gũi	g ũ i
gơ	g ơ
gơ-lu-xit	g ơ l u x i t
gơn-đờ-lu	g ơ n đ ờ l u
gươm	g ư ơ m
gương	g ư ơ n g
gườm	g ư ờ m
gường	g ư ờ n g
gưởi	g ư ở i
gưỡng	g ư ỡ n g
gượm	g ư ợ m
gượng	g ư ợ n g
gạ	g ạ
gạc	g ạ c
gạch	g ạ c h
gại	g ạ i
gạn	g ạ n
gạnh	g ạ n h
gạo	g ạ o
gạt	g ạ t
gạy	g ạ y
gả	g ả
gảnh	g ả n h
gảy	g ả y
gấc	g ấ c
gấm	g ấ m
gấp	g ấ p
gấu	g ấ u
gấy	g ấ y
gầm	g ầ m
gần	g ầ n
gầu	g ầ u
gầy	g ầ y
gẩm	g ẩ m
gẩy	g ẩ y
gẫm	g ẫ m
gẫu	g ẫ u
gẫy	g ẫ y
gậm	g ậ m
gận	g ậ n
gập	g ậ p
gật	g ậ t
gậy	g ậ y
gắm	g ắ m
gắn	g ắ n
gắng	g ắ n g
gắp	g ắ p
gắt	g ắ t
gằm	g ằ m
gằn	g ằ n
gẵng	g ẵ n g
gặc	g ặ c
gặm	g ặ m
gặn	g ặ n
gặng	g ặ n g
gặp	g ặ p
gặt	g ặ t
gỉ	g ỉ
gịa	g ị a
gọ	g ọ
gọc	g ọ c
gọi	g ọ i
gọn	g ọ n
gọng	g ọ n g
gọt	g ọ t
gỏi	g ỏ i
gỏng	g ỏ n g
gốc	g ố c
gối	g ố i
gốm	g ố m
gồ	g ồ
gồi	g ồ i
gồm	g ồ m
gồng	g ồ n g
gổ	g ổ
gỗ	g ỗ
gộ	g ộ
gộc	g ộ c
gội	g ộ i
gộp	g ộ p
gột	g ộ t
gớm	g ớ m
gờ	g ờ
gờ-ram	g ờ r a m
gờm	g ờ m
gờn	g ờ n
gở	g ở
gởi	g ở i
gỡ	g ỡ
gợi	g ợ i
gợn	g ợ n
gợt	g ợ t
gụ	g ụ
gục	g ụ c
gụi	g ụ i
gụt	g ụ t
gủa	g ủ a
gứng	g ứ n g
gừ	g ừ
gừng	g ừ n g
gửi	g ử i
gữi	g ữ i
h	h
ha	h a
ha-lô-gien	h a l ô g i e n
hachidiru	h a c h i d i r u
hack	h a c k
hacker	h a c k e r
hai	h a i
haley	h a l e y
hall	h a l l
halloween	h a l l o w e e n
ham	h a m
hamburger	h a m b u r g e r
hamden	h a m d e n
hamlet	h a m l e t
hamman	h a m m a n
han	h a n
hang	h a n g
hanh	h a n h
hani	h a n i
hanna	h a n n a
hannibal	h a n n i b a l
hans	h a n s
hantuchova	h a n t u c h o v a
hao	h a o
hara	h a r a
harada	h a r a d a
hardy	h a r d y
hargreaves	h a r g r e a v e s
harmonica	h a r m o n i c a
harrison	h a r r i s o n
harry	h a r r y
hart	h a r t
haruko	h a r u k o
hasebe	h a s e b e
hashimoto	h a s h i m o t o
hat	h a t
hatchback	h a t c h b a c k
hattie	h a t t i e
hattrick	h a t t r i c k
hau	h a u
haute	h a u t e
hawaii	h a w a i i
hawaiian	h a w a i i a n
hawk	h a w k
hay	h a y
hay!	h a y !
hayward	h a y w a r d
hbo	h b o
he	h e
he-li	h e l i
he-ma-tít	h e m a t í t
he-rô-in	h e r ô i n
head	h e a d
heathrow	h e a t h r o w
hec	h e c
hee	h e e
heights	h e i g h t s
help	h e l p
helsinki	h e l s i n k i
hem	h e m
hen	h e n
heng	h e n g
henry	h e n r y
heo	h e o
hepburn	h e p b u r n
hera	h e r a
herd	h e r d
hernandez	h e r n a n d e z
heroin	h e r o i n
herrera	h e r r e r a
hi	h i
hi-la	h i l a
hi-pe-bon	h i p e b o n
hi-pe-bôn	h i p e b ô n
hia	h i a
hideyuki	h i d e y u k i
high	h i g h
hill	h i l l
hills	h i l l s
hilton	h i l t o n
him	h i m
hin	h i n
hingis	h i n g i s
hinh	h i n h
hiroshi	h i r o s h i
hiroshima	h i r o s h i m a
history	h i s t o r y
hit	h i t
hitler	h i t l e r
hiu	h i u
hiv	h i v
hix	h i x
hiêm	h i ê m
hiên	h i ê n
hiêng	h i ê n g
hiêu	h i ê u
hiếc	h i ế c
hiếm	h i ế m
hiến	h i ế n
hiếng	h i ế n g
hiếp	h i ế p
hiết	h i ế t
hiếu	h i ế u
hiềm	h i ề m
hiền	h i ề n
hiểm	h i ể m
hiển	h i ể n
hiểu	h i ể u
hiện	h i ệ n
hiệp	h i ệ p
hiệt	h i ệ t
hiệu	h i ệ u
hlv	h l v
ho	h o
ho-bo	h o b o
hoa	h o a
hoai	h o a i
hoan	h o a n
hoang	h o a n g
hoanh	h o a n h
hoay	h o a y
hobart	h o b a r t
hockey	h o c k e y
hodgson	h o d g s o n
hoe	h o e
hoen	h o e n
hoffenheim	h o f f e n h e i m
hoi	h o i
hok	h o k
hokkaido	h o k k a i d o
holiday	h o l i d a y
hollyhock	h o l l y h o c k
hollywood	h o l l y w o o d
holmes	h o l m e s
hom	h o m
home	h o m e
homer	h o m e r
hon	h o n
honda	h o n d a
hong	h o n g
hongkong	h o n g k o n g
honolulu	h o n o l u l u
hope	h o p e
hormone	h o r m o n e
hornung	h o r n u n g
horyu	h o r y u
hosni	h o s n i
hot	h o t
hotel	h o t e l
hoà	h o à
hoài	h o à i
hoàn	h o à n
hoàng	h o à n g
hoành	h o à n h
hoá	h o á
hoác	h o á c
hoái	h o á i
hoán	h o á n
hoáng	h o á n g
hoánh	h o á n h
hoáy	h o á y
hoãn	h o ã n
hoãng	h o ã n g
hoè	h o è
hoét	h o é t
hoóc	h o ó c
hoóc-mon	h o ó c m o n
hoóc-môn	h o ó c m ô n
hoăm	h o ă m
hoăng	h o ă n g
hoạ	h o ạ
hoạch	h o ạ c h
hoại	h o ạ i
hoạn	h o ạ n
hoạnh	h o ạ n h
hoạt	h o ạ t
hoả	h o ả
hoải	h o ả i
hoản	h o ả n
hoảng	h o ả n g
hoảnh	h o ả n h
hoắc	h o ắ c
hoắm	h o ắ m
hoắt	h o ắ t
hoằn	h o ằ n
hoằng	h o ằ n g
hoẳn	h o ẳ n
hoẵng	h o ẵ n g
hoặc	h o ặ c
hoặn	h o ặ n
hoẹ	h o ẹ
hoẹt	h o ẹ t
hoẻn	h o ẻ n
hu	h u
hua	h u a
hui	h u i
hula	h u l a
hull	h u l l
hum	h u m
hun	h u n
hung	h u n g
hungary	h u n g a r y
hunger	h u n g e r
huy	h u y
huyndai	h u y n d a i
huynh	h u y n h
huyên	h u y ê n
huyến	h u y ế n
huyết	h u y ế t
huyền	h u y ề n
huyển	h u y ể n
huyễn	h u y ễ n
huyện	h u y ệ n
huyệt	h u y ệ t
huân	h u â n
huê	h u ê
huênh	h u ê n h
huý	h u ý
huých	h u ý c h
huýnh	h u ý n h
huýt	h u ý t
huơ	h u ơ
huấn	h u ấ n
huầy	h u ầ y
huế	h u ế
huếch	h u ế c h
huề	h u ề
huệ	h u ệ
huống	h u ố n g
huốt	h u ố t
huổi	h u ổ i
huỳnh	h u ỳ n h
huỵch	h u ỵ c h
huỷ	h u ỷ
hy	h y
hybrid	h y b r i d
hyde	h y d e
hyun	h y u n
hà	h à
hà-lan	h à l a n
hà-lăng	h à l ă n g
hà-đông	h à đ ô n g
hài	h à i
hàm	h à m
hàn	h à n
hàng	h à n g
hành	h à n h
hào	h à o
hàu	h à u
há	h á
hác	h á c
hác-pơ	h á c p ơ
hách	h á c h
hái	h á i
hám	h á m
hán	h á n
háng	h á n g
hánh	h á n h
háo	h á o
háp	h á p
háp-trắc	h á p t r ắ c
hát	h á t
háu	h á u
háy	h á y
hâm	h â m
hân	h â n
hâu	h â u
hây	h â y
hãi	h ã i
hãm	h ã m
hãn	h ã n
hãng	h ã n g
hãnh	h ã n h
hão	h ã o
hãy	h ã y
hè	h è
hè-thu	h è t h u
hèm	h è m
hèn	h è n
hèo	h è o
hé	h é
héc	h é c
héc-ta	h é c t a
héc-to	h é c t o
héc-tô-gam	h é c t ô g a m
héc-tô-lít	h é c t ô l í t
héc-tô-mét	h é c t ô m é t
hén	h é n
héo	h é o
hét	h é t
hê	h ê
hê-li	h ê l i
hê-ma-tit	h ê m a t i t
hê-ma-tít	h ê m a t í t
hê-mô-giô-bin	h ê m ô g i ô b i n
hê-rô-in	h ê r ô i n
hên	h ê n
hênh	h ê n h
hì	h ì
hình	h ì n h
hí	h í
hích	h í c h
híp	h í p
híp-pi	h í p p i
hít	h í t
hò	h ò
hòa	h ò a
hòe	h ò e
hòi	h ò i
hòm	h ò m
hòn	h ò n
hòng	h ò n g
hó	h ó
hóa	h ó a
hóc	h ó c
hói	h ó i
hóm	h ó m
hón	h ó n
hóng	h ó n g
hóp	h ó p
hót	h ó t
hô	h ô
hô!	h ô !
hôi	h ô i
hôm	h ô m
hôn	h ô n
hông	h ô n g
hõa	h õ a
hõm	h õ m
hù	h ù
hùa	h ù a
hùi	h ù i
hùm	h ù m
hùn	h ù n
hùng	h ù n g
hú	h ú
húc	h ú c
húi	h ú i
húm	h ú m
húng	h ú n g
húp	h ú p
hút	h ú t
húy	h ú y
hý	h ý
hăm	h ă m
hăng	h ă n g
hĩ	h ĩ
hĩm	h ĩ m
hĩnh	h ĩ n h
hũ	h ũ
hũm	h ũ m
hơ	h ơ
hơi	h ơ i
hơn	h ơ n
hơng	h ơ n g
hơp	h ơ p
hư	h ư
hưng	h ư n g
hưu	h ư u
hươm	h ư ơ m
hươn	h ư ơ n
hương	h ư ơ n g
hươu	h ư ơ u
hước	h ư ớ c
hướm	h ư ớ m
hướng	h ư ớ n g
hườm	h ư ờ m
hường	h ư ờ n g
hưởng	h ư ở n g
hượm	h ư ợ m
hạ	h ạ
hạc	h ạ c
hạch	h ạ c h
hại	h ạ i
hạm	h ạ m
hạn	h ạ n
hạng	h ạ n g
hạnh	h ạ n h
hạo	h ạ o
hạp	h ạ p
hạt	h ạ t
hạy	h ạ y
hả	h ả
hải	h ả i
hải-vương	h ả i v ư ơ n g
hảm	h ả m
hảng	h ả n g
hảnh	h ả n h
hảo	h ả o
hảy	h ả y
hấc	h ấ c
hấm	h ấ m
hấn	h ấ n
hấng	h ấ n g
hấp	h ấ p
hất	h ấ t
hấu	h ấ u
hấy	h ấ y
hầm	h ầ m
hầu	h ầ u
hầy	h ầ y
hẩm	h ẩ m
hẩng	h ẩ n g
hẩu	h ẩ u
hẩy	h ẩ y
hẫng	h ẫ n g
hẫu	h ẫ u
hậm	h ậ m
hận	h ậ n
hập	h ậ p
hật	h ậ t
hậu	h ậ u
hắc	h ắ c
hắn	h ắ n
hắng	h ắ n g
hắt	h ắ t
hằm	h ằ m
hằn	h ằ n
hằng	h ằ n g
hẳm	h ẳ m
hẳn	h ẳ n
hẵm	h ẵ m
hẵng	h ẵ n g
hặc	h ặ c
hặm	h ặ m
hẹ	h ẹ
hẹm	h ẹ m
hẹn	h ẹ n
hẹp	h ẹ p
hẹt	h ẹ t
hẻ	h ẻ
hẻm	h ẻ m
hẻn	h ẻ n
hẻo	h ẻ o
hẽm	h ẽ m
hếch	h ế c h
hến	h ế n
hết	h ế t
hếu	h ế u
hề	h ề
hềnh	h ề n h
hều	h ề u
hể	h ể
hển	h ể n
hểnh	h ể n h
hểu	h ể u
hễ	h ễ
hệ	h ệ
hệch	h ệ c h
hệt	h ệ t
hỉ	h ỉ
hỉnh	h ỉ n h
hị	h ị
hịch	h ị c h
họ	h ọ
họa	h ọ a
học	h ọ c
họccặp	h ọ c c ặ p
họe	h ọ e
họng	h ọ n g
họp	h ọ p
hỏ	h ỏ
hỏa	h ỏ a
hỏi	h ỏ i
hỏm	h ỏ m
hỏn	h ỏ n
hỏng	h ỏ n g
hố	h ố
hốc	h ố c
hối	h ố i
hống	h ố n g
hốt	h ố t
hồ	h ồ
hồi	h ồ i
hồn	h ồ n
hồng	h ồ n g
hổ	h ổ
hổi	h ổ i
hổm	h ổ m
hổn	h ổ n
hổng	h ổ n g
hỗ	h ỗ
hỗm	h ỗ m
hỗn	h ỗ n
hỗng	h ỗ n g
hộ	h ộ
hộc	h ộ c
hội	h ộ i
hộn	h ộ n
hộp	h ộ p
hột	h ộ t
hớ	h ớ
hới	h ớ i
hớm	h ớ m
hớn	h ớ n
hớp	h ớ p
hớt	h ớ t
hờ	h ờ
hời	h ờ i
hờm	h ờ m
hờn	h ờ n
hở	h ở
hởi	h ở i
hởn	h ở n
hỡ	h ỡ
hỡi	h ỡ i
hỡm	h ỡ m
hợi	h ợ i
hợm	h ợ m
hợp	h ợ p
hợp-phố	h ợ p p h ố
hợt	h ợ t
hụ	h ụ
hục	h ụ c
hụi	h ụ i
hụm	h ụ m
hụp	h ụ p
hụt	h ụ t
hủ	h ủ
hủi	h ủ i
hủm	h ủ m
hủn	h ủ n
hủng	h ủ n g
hủy	h ủ y
hứ	h ứ
hứ!	h ứ !
hứa	h ứ a
hức	h ứ c
hứng	h ứ n g
hừ	h ừ
hừ!	h ừ !
hừa	h ừ a
hừm	h ừ m
hừng	h ừ n g
hử	h ử
hửng	h ử n g
hữ	h ữ
hững	h ữ n g
hữu	h ữ u
hự	h ự
hực	h ự c
hựu	h ự u
hỷ	h ỷ
i	i
i-nốc	i n ố c
i-on	i o n
i-tan	i t a n
i-tờ	i t ờ
i-ô-ga	i ô g a
i-ôn	i ô n
i-ốt	i ố t
ibm	i b m
ic	i c
icahn	i c a h n
iceland	i c e l a n d
icon	i c o n
ida	i d a
igc	i g c
ii	i i
iijima	i i j i m a
ikeda	i k e d a
il	i l
im	i m
imel	i m e l
in	i n
in-mê-nhít	i n m ê n h í t
in-su-lin	i n s u l i n
in-tơ-nét	i n t ơ n é t
in-va	i n v a
in-xu-lin	i n x u l i n
in-đi	i n đ i
inch	i n c h
inches	i n c h e s
indeed	i n d e e d
index	i n d e x
indian	i n d i a n
indonesia	i n d o n e s i a
industry	i n d u s t r y
infiniti	i n f i n i t i
infinity	i n f i n i t y
inh	i n h
inn	i n n
inna	i n n a
innocent	i n n o c e n t
insulin	i n s u l i n
intel	i n t e l
inter	i n t e r
internet	i n t e r n e t
interpol	i n t e r p o l
invest	i n v e s t
ion	i o n
ios	i o s
ip	i p
ipad	i p a d
iphone	i p h o n e
ipod	i p o d
iran	i r a n
iraq	i r a q
ireland	i r e l a n d
is	i s
ish	i s h
ishibashi	i s h i b a s h i
ishida	i s h i d a
israel	i s r a e l
it	i t
italia	i t a l i a
italy	i t a l y
item	i t e m
itunes	i t u n e s
iu	i u
ivan	i v a n
j	j
jack	j a c k
jackie	j a c k i e
jackson	j a c k s o n
jacksonville	j a c k s o n v i l l e
jae	j a e
jakarta	j a k a r t a
jake	j a k e
jal	j a l
jamie	j a m i e
jane	j a n e
jang	j a n g
japan	j a p a n
jardin	j a r d i n
jardine	j a r d i n e
jasmine	j a s m i n e
jasper	j a s p e r
java	j a v a
javier	j a v i e r
jaya	j a y a
jazz	j a z z
jean	j e a n
jeddah	j e d d a h
jeffrey	j e f f r e y
jen	j e n
jennifer	j e n n i f e r
jerry	j e r r y
jerusalem	j e r u s a l e m
jessica	j e s s i c a
jesus	j e s u s
jett	j e t t
ji	j i
jie	j i e
jim	j i m
jimmy	j i m m y
jin	j i n
jinx	j i n x
jiyugaoka	j i y u g a o k a
jm	j m
joao	j o a o
job	j o b
jobs	j o b s
joe	j o e
johan	j o h a n
john	j o h n
johnny	j o h n n y
johnson	j o h n s o n
jolie	j o l i e
jones	j o n e s
jong	j o n g
jonh	j o n h
joon	j o o n
joong	j o o n g
joseph	j o s e p h
josephine	j o s e p h i n e
jr	j r
ju	j u
judo	j u d o
julia	j u l i a
julie	j u l i e
juliet	j u l i e t
jun	j u n
june	j u n e
jung	j u n g
jungle	j u n g l e
junichiro	j u n i c h i r o
justin	j u s t i n
juve	j u v e
juventus	j u v e n t u s
k	k
ka	k a
ka-ki	k a k i
ka-li	k a l i
ka-ra-tê	k a r a t ê
ka-ra-tê-đô	k a r a t ê đ ô
ka-ra-ô-kê	k a r a ô k ê
kabuki	k a b u k i
kahn	k a h n
kai	k a i
kaka	k a k a
kaki	k a k i
kaladze	k a l a d z e
kali	k a l i
kamen	k a m e n
kan-tua	k a n t u a
kang	k a n g
kangaroo	k a n g a r o o
kansai	k a n s a i
kanto	k a n t o
kao	k a o
karachi	k a r a c h i
karaoke	k a r a o k e
karin	k a r i n
karira	k a r i r a
kate	k a t e
katharine	k a t h a r i n e
katherine	k a t h e r i n e
kathleen	k a t h l e e n
kathyra	k a t h y r a
katia	k a t i a
kawaramachi	k a w a r a m a c h i
kay	k a y
kazakhstan	k a z a k h s t a n
kazu	k a z u
ke	k e
keegan	k e e g a n
keith	k e i t h
kelly	k e l l y
kelvin	k e l v i n
kem	k e m
kemper	k e m p e r
ken	k e n
ken-vin	k e n v i n
keng	k e n g
kenichi	k e n i c h i
kenji	k e n j i
kentaro	k e n t a r o
keo	k e o
kerns	k e r n s
kerr	k e r r
kevin	k e v i n
key	k e y
kg	k g
kha	k h a
khai	k h a i
kham	k h a m
khamtai	k h a m t a i
khamtay	k h a m t a y
khan	k h a n
khang	k h a n g
khanh	k h a n h
khao	k h a o
khau	k h a u
khay	k h a y
khe	k h e
khem	k h e m
khen	k h e n
kheo	k h e o
khi	k h i
khin	k h i n
khinh	k h i n h
khiu	k h i u
khiêm	k h i ê m
khiên	k h i ê n
khiêng	k h i ê n g
khiêu	k h i ê u
khiếm	k h i ế m
khiến	k h i ế n
khiếp	k h i ế p
khiết	k h i ế t
khiếu	k h i ế u
khiền	k h i ề n
khiểm	k h i ể m
khiển	k h i ể n
khiểng	k h i ể n g
khiễng	k h i ễ n g
khiệm	k h i ệ m
khiệng	k h i ệ n g
khmer	k h m e r
kho	k h o
khoa	k h o a
khoai	k h o a i
khoan	k h o a n
khoang	k h o a n g
khoanh	k h o a n h
khoe	k h o e
khoen	k h o e n
khoeo	k h o e o
khoi	k h o i
khom	k h o m
khoong	k h o o n g
khoành	k h o à n h
khoào	k h o à o
khoá	k h o á
khoác	k h o á c
khoách	k h o á c h
khoái	k h o á i
khoán	k h o á n
khoáng	k h o á n g
khoát	k h o á t
khoáy	k h o á y
khoèo	k h o è o
khoé	k h o é
khoén	k h o é n
khoét	k h o é t
khoăm	k h o ă m
khoăn	k h o ă n
khoạng	k h o ạ n g
khoả	k h o ả
khoải	k h o ả i
khoản	k h o ả n
khoảng	k h o ả n g
khoảnh	k h o ả n h
khoắc	k h o ắ c
khoắm	k h o ắ m
khoắn	k h o ắ n
khoắng	k h o ắ n g
khoắt	k h o ắ t
khoằm	k h o ằ m
khoặm	k h o ặ m
khoẻ	k h o ẻ
khoẻo	k h o ẻ o
khrushchev	k h r u s h c h e v
khu	k h u
khua	k h u a
khui	k h u i
khum	k h u m
khung	k h u n g
khuy	k h u y
khuya	k h u y a
khuynh	k h u y n h
khuyên	k h u y ê n
khuyến	k h u y ế n
khuyết	k h u y ế t
khuyển	k h u y ể n
khuân	k h u â n
khuâng	k h u â n g
khuây	k h u â y
khuê	k h u ê
khuôn	k h u ô n
khuông	k h u ô n g
khuých	k h u ý c h
khuýp	k h u ý p
khuơ	k h u ơ
khuất	k h u ấ t
khuấy	k h u ấ y
khuẩn	k h u ẩ n
khuẩn-huyết	k h u ẩ n h u y ế t
khuắng	k h u ắ n g
khuế	k h u ế
khuếch	k h u ế c h
khuể	k h u ể
khuờ	k h u ờ
khuỳnh	k h u ỳ n h
khuỵ	k h u ỵ
khuỵu	k h u ỵ u
khuỷnh	k h u ỷ n h
khuỷu	k h u ỷ u
khyển	k h y ể n
khà	k h à
khàn	k h à n
khàng	k h à n g
khành	k h à n h
khào	k h à o
khá	k h á
khác	k h á c
khách	k h á c h
khái	k h á i
khám	k h á m
khán	k h á n
kháng	k h á n g
khánh	k h á n h
khánh-hạ	k h á n h h ạ
kháo	k h á o
kháp	k h á p
khát	k h á t
kháu	k h á u
kháy	k h á y
khâm	k h â m
khân	k h â n
khâng	k h â n g
khâu	k h â u
khè	k h è
khèn	k h è n
khèng	k h è n g
khèo	k h è o
khé	k h é
khén	k h é n
khéo	k h é o
khép	k h é p
khét	k h é t
khê	k h ê
khênh	k h ê n h
khêu	k h ê u
khì	k h ì
khìn	k h ì n
khí	k h í
khía	k h í a
khích	k h í c h
khín	k h í n
khính	k h í n h
khít	k h í t
khíu	k h í u
khò	k h ò
khòa	k h ò a
khòe	k h ò e
khòm	k h ò m
khòn	k h ò n
khòng	k h ò n g
khó	k h ó
khóa	k h ó a
khóc	k h ó c
khóe	k h ó e
khói	k h ó i
khóm	k h ó m
khô	k h ô
khôi	k h ô i
khôn	k h ô n
khôn!	k h ô n !
không	k h ô n g
khôống	k h ô ố n g
khù	k h ù
khù-sung	k h ù s u n g
khùa	k h ù a
khùng	k h ù n g
khú	k h ú
khúc	k h ú c
khúm	k h ú m
khúng	k h ú n g
khăm	k h ă m
khăn	k h ă n
khăng	k h ă n g
khĩnh	k h ĩ n h
khơ	k h ơ
khơ-me	k h ơ m e
khơ-mú	k h ơ m ú
khơi	k h ơ i
khư	k h ư
khươi	k h ư ơ i
khươm	k h ư ơ m
khươn	k h ư ơ n
khương	k h ư ơ n g
khước	k h ư ớ c
khướt	k h ư ớ t
khướu	k h ư ớ u
khưởng	k h ư ở n g
khưỡng	k h ư ỡ n g
khượt	k h ư ợ t
khạ	k h ạ
khạc	k h ạ c
khạch	k h ạ c h
khạng	k h ạ n g
khạo	k h ạ o
khạp	k h ạ p
khả	k h ả
khảch	k h ả c h
khải	k h ả i
khảm	k h ả m
khản	k h ả n
khảng	k h ả n g
khảnh	k h ả n h
khảo	k h ả o
khảy	k h ả y
khấc	k h ấ c
khấm	k h ấ m
khấn	k h ấ n
khấp	k h ấ p
khất	k h ấ t
khấu	k h ấ u
khần	k h ầ n
khầng	k h ầ n g
khẩn	k h ẩ n
khẩu	k h ẩ u
khẩy	k h ẩ y
khậc	k h ậ c
khậm	k h ậ m
khập	k h ậ p
khật	k h ậ t
khắc	k h ắ c
khắm	k h ắ m
khắn	k h ắ n
khắng	k h ắ n g
khắp	k h ắ p
khắt	k h ắ t
khằn	k h ằ n
khằng	k h ằ n g
khẳm	k h ẳ m
khẳn	k h ẳ n
khẳng	k h ẳ n g
khặc	k h ặ c
khặm	k h ặ m
khẹc	k h ẹ c
khẻ	k h ẻ
khẻo	k h ẻ o
khẽ	k h ẽ
khế	k h ế
khề	k h ề
khềnh	k h ề n h
khều	k h ề u
khể	k h ể
khểnh	k h ể n h
khễnh	k h ễ n h
khệ	k h ệ
khệch	k h ệ c h
khệnh	k h ệ n h
khỉ	k h ỉ
khỉnh	k h ỉ n h
khị	k h ị
khịa	k h ị a
khịt	k h ị t
khịu	k h ị u
khọm	k h ọ m
khọt	k h ọ t
khỏ	k h ỏ
khỏa	k h ỏ a
khỏe	k h ỏ e
khỏi	k h ỏ i
khỏng	k h ỏ n g
khố	k h ố
khốc	k h ố c
khối	k h ố i
khốn	k h ố n
khống	k h ố n g
khốt	k h ố t
khổ	k h ổ
khổn	k h ổ n
khổng	k h ổ n g
khổthân	k h ổ t h â n
khớ	k h ớ
khới	k h ớ i
khớp	k h ớ p
khờ	k h ờ
khởi	k h ở i
khụ	k h ụ
khục	k h ụ c
khụng	k h ụ n g
khụt	k h ụ t
khụy	k h ụ y
khủ	k h ủ
khủa	k h ủ a
khủng	k h ủ n g
khứ	k h ứ
khứa	k h ứ a
khứng	k h ứ n g
khứu	k h ứ u
khừ	k h ừ
khừa	k h ừ a
khừng	k h ừ n g
khử	k h ử
khự	k h ự
khựng	k h ự n g
ki	k i
ki-lô	k i l ô
ki-lô-gam	k i l ô g a m
ki-lô-mét	k i l ô m é t
ki-lô-oát	k i l ô o á t
ki-lô-vôn	k i l ô v ô n
ki-mô-nô	k i m ô n ô
ki-nin	k i n i n
ki-tô	k i t ô
ki-ốt	k i ố t
kia	k i a
kid	k i d
kidman	k i d m a n
kiev	k i e v
kilô	k i l ô
kilôgam	k i l ô g a m
kilômét	k i l ô m é t
kim	k i m
kimono	k i m o n o
kimura	k i m u r a
kin	k i n
kinh	k i n h
kinh-tế	k i n h t ế
kip	k i p
kissed	k i s s e d
kitano	k i t a n o
kitty	k i t t y
kitô	k i t ô
kiwi	k i w i
kiêm	k i ê m
kiên	k i ê n
kiêng	k i ê n g
kiêu	k i ê u
kiêu-kị	k i ê u k ị
kiếm	k i ế m
kiến	k i ế n
kiếng	k i ế n g
kiếp	k i ế p
kiết	k i ế t
kiếu	k i ế u
kiềm	k i ề m
kiền	k i ề n
kiềng	k i ề n g
kiều	k i ề u
kiểm	k i ể m
kiển	k i ể n
kiểng	k i ể n g
kiểu	k i ể u
kiễng	k i ễ n g
kiệm	k i ệ m
kiện	k i ệ n
kiệp	k i ệ p
kiệt	k i ệ t
kiệu	k i ệ u
km	k m
ko	k o
kobaya	k o b a y a
kobayashi	k o b a y a s h i
kobe	k o b e
kodak	k o d a k
kojima	k o j i m a
kombat	k o m b a t
kon	k o n
kong	k o n g
kool	k o o l
koscielny	k o s c i e l n y
kristen	k r i s t e n
krông	k r ô n g
ku	k u
kuala	k u a l a
kubo	k u b o
kuman	k u m a n
kumanthong	k u m a n t h o n g
kumanthông	k u m a n t h ô n g
kuênh	k u ê n h
kuýp	k u ý p
kvitova	k v i t o v a
ky	k y
kyodo	k y o d o
kyoko	k y o k o
kyoto	k y o t o
kyoyu	k y o y u
kyung	k y u n g
kyushu	k y u s h u
káp-pa	k á p p a
kè	k è
kèm	k è m
kèn	k è n
kèo	k è o
ké	k é
kéc	k é c
kém	k é m
kén	k é n
kéo	k é o
kép	k é p
két	k é t
két-xông	k é t x ô n g
kê	k ê
kê-môn	k ê m ô n
kê-pi	k ê p i
kên	k ê n
kêng	k ê n g
kênh	k ê n h
kêu	k ê u
kì	k ì
kìa	k ì a
kìm	k ì m
kìn	k ì n
kình	k ì n h
kí	k í
kí-lô	k í l ô
kí-ninh	k í n i n h
kích	k í c h
kín	k í n
kính	k í n h
kíp	k í p
kíp-lê	k í p l ê
kít	k í t
kíu	k í u
kót	k ó t
kôn	k ô n
kông	k ô n g
ký	k ý
ký-ninh	k ý n i n h
kĩ	k ĩ
kĩn	k ĩ n
kĩu	k ĩ u
kơi	k ơ i
kạn	k ạ n
kẹ	k ẹ
kẹn	k ẹ n
kẹo	k ẹ o
kẹp	k ẹ p
kẹt	k ẹ t
kẻ	k ẻ
kẻm	k ẻ m
kẻng	k ẻ n g
kẻo	k ẻ o
kẽ	k ẽ
kẽm	k ẽ m
kẽo	k ẽ o
kế	k ế
kếch	k ế c h
kếp	k ế p
kết	k ế t
kếu	k ế u
kề	k ề
kềm	k ề m
kền	k ề n
kềnh	k ề n h
kều	k ề u
kể	k ể
kễnh	k ễ n h
kệ	k ệ
kệch	k ệ c h
kệnh	k ệ n h
kệt	k ệ t
kỉ	k ỉ
kỉnh	k ỉ n h
kị	k ị
kịa	k ị a
kịch	k ị c h
kịp	k ị p
kịt	k ị t
kốc	k ố c
kụ	k ụ
kỳ	k ỳ
kỵ	k ỵ
kỷ	k ỷ
kỹ	k ỹ
la	l a
la-bô	l a b ô
la-coóc	l a c o ó c
la-de	l a d e
la-dơn	l a d ơ n
la-ga	l a g a
la-ghe	l a g h e
la-ghim	l a g h i m
la-mát	l a m á t
la-mã	l a m ã
la-oang	l a o a n g
la-phông	l a p h ô n g
la-sát	l a s á t
la-tinh	l a t i n h
la-tê-rít	l a t ê r í t
la-va-bô	l a v a b ô
la-vầy	l a v ầ y
la-xiết	l a x i ế t
la-đơn	l a đ ơ n
laden	l a d e n
lady	l a d y
lai	l a i
lai-ly	l a i l y
lai-đa	l a i đ a
lake	l a k e
lam	l a m
lam-đa	l a m đ a
lama	l a m a
lan	l a n
lancet	l a n c e t
landing	l a n d i n g
lane	l a n e
lang	l a n g
lanh	l a n h
lanh-tô	l a n h t ô
lao	l a o
laptop	l a p t o p
lara	l a r a
las	l a s
laser	l a s e r
lat	l a t
lau	l a u
lauder	l a u d e r
laura	l a u r a
laurence	l a u r e n c e
laurie	l a u r i e
lavor	l a v o r
lay	l a y
lay-dơn	l a y d ơ n
lay-ơn	l a y ơ n
layer	l a y e r
layout	l a y o u t
lazaro	l a z a r o
le	l e
le-va	l e v a
league	l e a g u e
lee	l e e
legging	l e g g i n g
leicester	l e i c e s t e r
leigh	l e i g h
leighton	l e i g h t o n
lem	l e m
len	l e n
lena	l e n a
leng	l e n g
lenin	l e n i n
leningrad	l e n i n g r a d
lennon	l e n n o n
leo	l e o
lester	l e s t e r
let	l e t
level	l e v e l
leverkusen	l e v e r k u s e n
levi	l e v i
levine	l e v i n e
lewandowski	l e w a n d o w s k i
lewis	l e w i s
lexington	l e x i n g t o n
lexus	l e x u s
lg	l g
li	l i
li-e	l i e
li-mô-din	l i m ô d i n
li-mô-nát	l i m ô n á t
li-pít	l i p í t
li-thi	l i t h i
li-tô	l i t ô
li-vê	l i v ê
li-xê	l i x ê
li-xăng	l i x ă n g
lia	l i a
liam	l i a m
library	l i b r a r y
libya	l i b y a
lido	l i d o
like	l i k e
lily	l i l y
lim	l i m
limited	l i m i t e d
limos	l i m o s
limousine	l i m o u s i n e
lin	l i n
lincoln	l i n c o l n
linda	l i n d a
linh	l i n h
link	l i n k
lipo	l i p o
lippi	l i p p i
lipton	l i p t o n
lisa	l i s a
lisbon	l i s b o n
list	l i s t
little	l i t t l e
liu	l i u
live	l i v e
liverpool	l i v e r p o o l
lizzie	l i z z i e
liêm	l i ê m
liên	l i ê n
liêng	l i ê n g
liêu	l i ê u
liếc	l i ế c
liếm	l i ế m
liến	l i ế n
liếng	l i ế n g
liếp	l i ế p
liếu	l i ế u
liềm	l i ề m
liền	l i ề n
liềng	l i ề n g
liều	l i ề u
liểng	l i ể n g
liểu	l i ể u
liễm	l i ễ m
liễn	l i ễ n
liễng	l i ễ n g
liễu	l i ễ u
liệc	l i ệ c
liệm	l i ệ m
liện	l i ệ n
liệng	l i ệ n g
liệp	l i ệ p
liệt	l i ệ t
liệu	l i ệ u
lo	l o
lo-ga	l o g a
lo-ga-rit	l o g a r i t
loa	l o a
load	l o a d
loai	l o a i
loan	l o a n
loang	l o a n g
loanh	l o a n h
loay	l o a y
lock	l o c k
loe	l o e
loen	l o e n
logic	l o g i c
logo	l o g o
loi	l o i
lom	l o m
lon	l o n
london	l o n d o n
long	l o n g
loong	l o o n g
loong-toong	l o o n g t o o n g
lopez	l o p e z
lord	l o r d
lorenzo	l o r e n z o
los	l o s
louboutin	l o u b o u t i n
louis	l o u i s
louisiana	l o u i s i a n a
louisville	l o u i s v i l l e
lounge	l o u n g e
loà	l o à
loài	l o à i
loàn	l o à n
loàng	l o à n g
loá	l o á
loác	l o á c
loán	l o á n
loáng	l o á n g
loáo	l o á o
loát	l o á t
loáy	l o á y
loã	l o ã
loãng	l o ã n g
loè	l o è
loé	l o é
loét	l o é t
loăn	l o ă n
loăng	l o ă n g
loạc	l o ạ c
loạch	l o ạ c h
loại	l o ạ i
loạn	l o ạ n
loạng	l o ạ n g
loạt	l o ạ t
loả	l o ả
loảng	l o ả n g
loắn	l o ắ n
loắt	l o ắ t
loằn	l o ằ n
loằng	l o ằ n g
loẹt	l o ẹ t
loẻng	l o ẻ n g
loẻo	l o ẻ o
ls	l s
lu	l u
lua	l u a
luc	l u c
lucas	l u c a s
lucia	l u c i a
lucio	l u c i o
lui	l u i
lum	l u m
lumpur	l u m p u r
lung	l u n g
luy	l u y
luya	l u y a
luyn	l u y n
luyên	l u y ê n
luyến	l u y ế n
luyện	l u y ệ n
luyệt	l u y ệ t
luân	l u â n
luôm	l u ô m
luôn	l u ô n
luông	l u ô n g
luý	l u ý
luých	l u ý c h
luýnh	l u ý n h
luýt	l u ý t
luấn	l u ấ n
luẩn	l u ẩ n
luận	l u ậ n
luật	l u ậ t
luốc	l u ố c
luống	l u ố n g
luốt	l u ố t
luồi	l u ồ i
luồn	l u ồ n
luồng	l u ồ n g
luỗng	l u ỗ n g
luộc	l u ộ c
luộm	l u ộ m
luột	l u ộ t
luỵ	l u ỵ
luỹ	l u ỹ
ly	l y
lyon	l y o n
là	l à
lài	l à i
làm	l à m
làn	l à n
làng	l à n g
lành	l à n h
lào	l à o
làu	l à u
lày	l à y
lá	l á
lác	l á c
lác-tíc	l á c t í c
lách	l á c h
lái	l á i
lán	l á n
láng	l á n g
lánh	l á n h
láo	l á o
láp	l á p
lát	l á t
lát-ti	l á t t i
lát-xê	l á t x ê
láu	l á u
láy	l á y
lâm	l â m
lân	l â n
lâng	l â n g
lâp	l â p
lâu	l â u
lây	l â y
lã	l ã
lãi	l ã i
lãm	l ã m
lãn	l ã n
lãng	l ã n g
lãnh	l ã n h
lão	l ã o
lè	l è
lèm	l è m
lèn	l è n
lèng	l è n g
lèo	l è o
lé	l é
léc	l é c
lém	l é m
lén	l é n
léng	l é n g
léo	l é o
lép	l é p
lét	l é t
lê	l ê
lê-dương	l ê d ư ơ n g
lê-nin-nít	l ê n i n n í t
lên	l ê n
lênh	l ê n h
lêu	l ê u
lì	l ì
lìa	l ì a
lìm	l ì m
lìn	l ì n
lình	l ì n h
lìu	l ì u
lí	l í
lí'	l í
lía	l í a
lích	l í c h
lính	l í n h
líp	l í p
líp-phăng-xe	l í p p h ă n g x e
lít	l í t
lít-xê	l í t x ê
lít-xăng	l í t x ă n g
líu	l í u
lò	l ò
lò-xo	l ò x o
lòa	l ò a
lòe	l ò e
lòi	l ò i
lòm	l ò m
lòn	l ò n
lòng	l ò n g
ló	l ó
lóa	l ó a
lóc	l ó c
lóe	l ó e
lói	l ó i
lóm	l ó m
lóng	l ó n g
lóp	l ó p
lót	l ó t
lô	l ô
lô-ca-xông	l ô c a x ô n g
lô-can	l ô c a n
lô-cốt	l ô c ố t
lô-ga	l ô g a
lô-ga-rít	l ô g a r í t
lô-gích	l ô g í c h
lô-tô	l ô t ô
lôi	l ô i
lôm	l ô m
lôn	l ô n
lông	l ô n g
lông-tông	l ô n g t ô n g
lõ	l õ
lõa	l õ a
lõi	l õ i
lõm	l õ m
lõng	l õ n g
lù	l ù
lùa	l ù a
lùi	l ù i
lùm	l ù m
lùn	l ù n
lùng	l ù n g
lú	l ú
lúa	l ú a
lúc	l ú c
lúi	l ú i
lúm	l ú m
lún	l ú n
lúng	l ú n g
lúp	l ú p
lút	l ú t
lúy	l ú y
lý	l ý
lăk	l ă k
lăm	l ă m
lăn	l ă n
lăng	l ă n g
lăng-xê	l ă n g x ê
lĩ	l ĩ
lĩnh	l ĩ n h
lũ	l ũ
lũa	l ũ a
lũi	l ũ i
lũm	l ũ m
lũn	l ũ n
lũng	l ũ n g
lũy	l ũ y
lơ	l ơ
lơ-go	l ơ g o
lơi	l ơ i
lơn	l ơ n
lư	l ư
lưa	l ư a
lưng	l ư n g
lưu	l ư u
lươm	l ư ơ m
lươn	l ư ơ n
lương	l ư ơ n g
lưới	l ư ớ i
lướng	l ư ớ n g
lướp	l ư ớ p
lướt	l ư ớ t
lướu	l ư ớ u
lười	l ư ờ i
lườm	l ư ờ m
lườn	l ư ờ n
lường	l ư ờ n g
lưởi	l ư ở i
lưởng	l ư ở n g
lưỡi	l ư ỡ i
lưỡng	l ư ỡ n g
lược	l ư ợ c
lượm	l ư ợ m
lượn	l ư ợ n
lượng	l ư ợ n g
lượt	l ư ợ t
lạ	l ạ
lạc	l ạ c
lạc-dang	l ạ c d a n g
lạc-xon	l ạ c x o n
lạch	l ạ c h
lại	l ạ i
lạm	l ạ m
lạn	l ạ n
lạng	l ạ n g
lạnh	l ạ n h
lạo	l ạ o
lạp	l ạ p
lạt	l ạ t
lạt-ma	l ạ t m a
lạu	l ạ u
lạy	l ạ y
lả	l ả
lải	l ả i
lảm	l ả m
lảng	l ả n g
lảnh	l ả n h
lảo	l ả o
lảu	l ả u
lảy	l ả y
lấc	l ấ c
lấm	l ấ m
lấn	l ấ n
lấp	l ấ p
lất	l ấ t
lấu	l ấ u
lấy	l ấ y
lầm	l ầ m
lần	l ầ n
lầng	l ầ n g
lầu	l ầ u
lầy	l ầ y
lẩm	l ẩ m
lẩn	l ẩ n
lẩu	l ẩ u
lẩy	l ẩ y
lẫm	l ẫ m
lẫn	l ẫ n
lẫy	l ẫ y
lậm	l ậ m
lận	l ậ n
lập	l ậ p
lập-bô	l ậ p b ô
lập-gioòng	l ậ p g i o ò n g
lập-loòng	l ậ p l o ò n g
lập-lòn	l ậ p l ò n
lập-lắc	l ậ p l ắ c
lật	l ậ t
lậu	l ậ u
lậy	l ậ y
lắc	l ắ c
lắc-lê	l ắ c l ê
lắk	l ắ k
lắm	l ắ m
lắng	l ắ n g
lắp	l ắ p
lắt	l ắ t
lằm	l ằ m
lằn	l ằ n
lằng	l ằ n g
lẳm	l ẳ m
lẳn	l ẳ n
lẳng	l ẳ n g
lẵng	l ẵ n g
lặc	l ặ c
lặm	l ặ m
lặn	l ặ n
lặng	l ặ n g
lặp	l ặ p
lặt	l ặ t
lẹ	l ẹ
lẹm	l ẹ m
lẹn	l ẹ n
lẹo	l ẹ o
lẹp	l ẹ p
lẹt	l ẹ t
lẻ	l ẻ
lẻm	l ẻ m
lẻn	l ẻ n
lẻng	l ẻ n g
lẻo	l ẻ o
lẽ	l ẽ
lẽn	l ẽ n
lẽo	l ẽ o
lếch	l ế c h
lết	l ế t
lếu	l ế u
lề	l ề
lềnh	l ề n h
lều	l ề u
lể	l ể
lểu	l ể u
lễ	l ễ
lễu	l ễ u
lệ	l ệ
lệch	l ệ c h
lệnh	l ệ n h
lệt	l ệ t
lỉm	l ỉ m
lỉnh	l ỉ n h
lỉu	l ỉ u
lị	l ị
lịa	l ị a
lịch	l ị c h
lịm	l ị m
lịnh	l ị n h
lịt	l ị t
lịu	l ị u
lọ	l ọ
lọc	l ọ c
lọi	l ọ i
lọm	l ọ m
lọn	l ọ n
lọng	l ọ n g
lọp	l ọ p
lọt	l ọ t
lỏ	l ỏ
lỏa	l ỏ a
lỏi	l ỏ i
lỏm	l ỏ m
lỏn	l ỏ n
lỏng	l ỏ n g
lố	l ố
lốc	l ố c
lốc-kê	l ố c k ê
lốc-nốt	l ố c n ố t
lối	l ố i
lốm	l ố m
lốn	l ố n
lốp	l ố p
lốt	l ố t
lồ	l ồ
lồi	l ồ i
lồm	l ồ m
lồn	l ồ n
lồng	l ồ n g
lổ	l ổ
lổm	l ổ m
lổn	l ổ n
lổng	l ổ n g
lỗ	l ỗ
lỗi	l ỗ i
lỗm	l ỗ m
lộ	l ộ
lộc	l ộ c
lội	l ộ i
lộm	l ộ m
lộn	l ộ n
lộng	l ộ n g
lộp	l ộ p
lột	l ộ t
lớ	l ớ
lới	l ớ i
lớn	l ớ n
lớp	l ớ p
lớt	l ớ t
lờ	l ờ
lời	l ờ i
lờm	l ờ m
lờn	l ờ n
lở	l ở
lởi	l ở i
lởm	l ở m
lởn	l ở n
lỡ	l ỡ
lỡi	l ỡ i
lỡm	l ỡ m
lợ	l ợ
lợi	l ợ i
lợm	l ợ m
lợn	l ợ n
lợp	l ợ p
lợt	l ợ t
lụ	l ụ
lụa	l ụ a
lục	l ụ c
lụi	l ụ i
lụm	l ụ m
lụn	l ụ n
lụng	l ụ n g
lụp	l ụ p
lụt	l ụ t
lụy	l ụ y
lủ	l ủ
lủa	l ủ a
lủi	l ủ i
lủm	l ủ m
lủn	l ủ n
lủng	l ủ n g
lứa	l ứ a
lức	l ứ c
lứt	l ứ t
lừ	l ừ
lừa	l ừ a
lừng	l ừ n g
lử	l ử
lửa	l ử a
lửng	l ử n g
lữ	l ữ
lữa	l ữ a
lững	l ữ n g
lữu	l ữ u
lự	l ự
lựa	l ự a
lực	l ự c
lựng	l ự n g
lựu	l ự u
lỳ	l ỳ
lỵ	l ỵ
lỹ	l ỹ
m	m
ma	m a
ma-bùn	m a b ù n
ma-coong	m a c o o n g
ma-cà-bông	m a c à b ô n g
ma-cà-cúi	m a c à c ú i
ma-cà-rồng	m a c à r ồ n g
ma-cô	m a c ô
ma-de	m a d e
ma-dê	m a d ê
ma-dút	m a d ú t
ma-ga-din	m a g a d i n
ma-gi	m a g i
ma-gie	m a g i e
ma-giê	m a g i ê
ma-ke-tinh	m a k e t i n h
ma-ki-ê	m a k i ê
ma-két	m a k é t
ma-két-tinh	m a k é t t i n h
ma-kết-tinh	m a k ế t t i n h
ma-lách	m a l á c h
ma-lát	m a l á t
ma-men	m a m e n
ma-mút	m a m ú t
ma-măng	m a m ă n g
ma-nhe-tít	m a n h e t í t
ma-nhe-tô	m a n h e t ô
ma-nhi	m a n h i
ma-nhê-tô	m a n h ê t ô
ma-nhê-tô-phôn	m a n h ê t ô p h ô n
ma-ni-ven	m a n i v e n
ma-níp	m a n í p
ma-nơ-canh	m a n ơ c a n h
ma-nớp	m a n ớ p
ma-phi-a	m a p h i a
ma-phăm	m a p h ă m
ma-ra-tông	m a r a t ô n g
ma-rông	m a r ô n g
macs	m a c s
madison	m a d i s o n
madrid	m a d r i d
magic	m a g i c
mahmudi	m a h m u d i
mai	m a i
mail	m a i l
mainz	m a i n z
make	m a k e
malaga	m a l a g a
malan	m a l a n
malay	m a l a y
malaysia	m a l a y s i a
malicious	m a l i c i o u s
mall	m a l l
mallie	m a l l i e
man	m a n
man-gan	m a n g a n
man-nớp	m a n n ớ p
man-tô	m a n t ô
man-tô-da	m a n t ô d a
management	m a n a g e m e n t
manager	m a n a g e r
manchester	m a n c h e s t e r
mandi	m a n d i
manera	m a n e r a
mang	m a n g
mangan	m a n g a n
manh	m a n h
manhattan	m a n h a t t a n
mao	m a o
marathon	m a r a t h o n
marazzina	m a r a z z i n a
marche	m a r c h e
mardy	m a r d y
margaret	m a r g a r e t
margarita	m a r g a r i t a
maria	m a r i a
marie	m a r i e
marilyn	m a r i l y n
marine	m a r i n e
mario	m a r i o
mark	m a r k
market	m a r k e t
marry	m a r r y
martin	m a r t i n
martini	m a r t i n i
marx	m a r x
mary	m a r y
maryam	m a r y a m
masako	m a s a k o
massage	m a s s a g e
mastercard	m a s t e r c a r d
masumi	m a s u m i
match	m a t c h
matri	m a t r i
matsumoto	m a t s u m o t o
matte	m a t t e
mattel	m a t t e l
matthew	m a t t h e w
mau	m a u
maui	m a u i
maunet	m a u n e t
max	m a x
may	m a y
may-on-ne	m a y o n n e
may-so	m a y s o
may-ô	m a y ô
may-ơ	m a y ơ
maybe	m a y b e
mayflower	m a y f l o w e r
mayweather	m a y w e a t h e r
mazda	m a z d a
mccaffrey	m c c a f f r e y
mcdonald	m c d o n a l d
mcdougall	m c d o u g a l l
me	m e
me-don	m e d o n
me-dông	m e d ô n g
me-ga	m e g a
me-tan	m e t a n
me-xừ	m e x ừ
medan	m e d a n
medicine	m e d i c i n e
mehico	m e h i c o
melaka	m e l a k a
melbourne	m e l b o u r n e
mem	m e m
men	m e n
men-thớt	m e n t h ớ t
men-ton	m e n t o n
meng	m e n g
menlo	m e n l o
menu	m e n u
meo	m e o
mer	m e r
mercedes	m e r c e d e s
mercury	m e r c u r y
meridian	m e r i d i a n
merlu	m e r l u
messi	m e s s i
meta	m e t a
metro	m e t r o
metroly	m e t r o l y
metropolitan	m e t r o p o l i t a n
mexico	m e x i c o
mfl	m f l
mi	m i
mi-ca	m i c a
mi-cơ-rô	m i c ơ r ô
mi-li	m i l i
mi-li-gam	m i l i g a m
mi-li-mét	m i l i m é t
mi-mô-da	m i m ô d a
mi-ni	m i n i
mi-nơ	m i n ơ
mia	m i a
miami	m i a m i
mianshi	m i a n s h i
michael	m i c h a e l
michigan	m i c h i g a n
micky	m i c k y
microsoft	m i c r o s o f t
midas	m i d a s
mihajlovic	m i h a j l o v i c
mike	m i k e
mikel	m i k e l
milan	m i l a n
miley	m i l e y
milimét	m i l i m é t
miller	m i l l e r
mim	m i m
min	m i n
minh	m i n h
minh-hương	m i n h h ư ơ n g
mini	m i n i
minsk	m i n s k
mirage	m i r a g e
miranda	m i r a n d a
miss	m i s s
mississippi	m i s s i s s i p p i
missouri	m i s s o u r i
mitch	m i t c h
mito	m i t o
miu	m i u
mix	m i x
miên	m i ê n
miêu	m i ê u
miến	m i ế n
miếng	m i ế n g
miết	m i ế t
miếu	m i ế u
miền	m i ề n
miền-đay	m i ề n đ a y
miều	m i ề u
miểng	m i ể n g
miểu	m i ể u
miễn	m i ễ n
miễu	m i ễ u
miện	m i ệ n
miệng	m i ệ n g
miệt	m i ệ t
mm	m m
mo	m o
mo-no-me	m o n o m e
mo-ran	m o r a n
mo-rát	m o r á t
moa	m o a
moammar	m o a m m a r
moana	m o a n a
moay	m o a y
moay-ơ	m o a y ơ
mobile	m o b i l e
mobility	m o b i l i t y
mockingjay	m o c k i n g j a y
mod	m o d
model	m o d e l
modern	m o d e r n
mohammad	m o h a m m a d
moi	m o i
molecular	m o l e c u l a r
mom	m o m
moma	m o m a
mon	m o n
mondeo	m o n d e o
monfils	m o n f i l s
mong	m o n g
monica	m o n i c a
monroe	m o n r o e
monte	m o n t e
moong	m o o n g
moore	m o o r e
more	m o r e
morning	m o r n i n g
morris	m o r r i s
mortal	m o r t a l
moskva	m o s k v a
motogp	m o t o g p
motorola	m o t o r o l a
moóc	m o ó c
moóc-chi-ê	m o ó c c h i ê
moóc-chê	m o ó c c h ê
moóc-phin	m o ó c p h i n
mr	m r
mrs	m r s
mtr	m t r
mu	m u
mu-dích	m u d í c h
mua	m u a
mubarak	m u b a r a k
mudenge	m u d e n g e
mui	m u i
mullen	m u l l e n
muller	m u l l e r
mum	m u m
mun	m u n
mung	m u n g
murakami	m u r a k a m i
murray	m u r r a y
museum	m u s e u m
musical	m u s i c a l
muy	m u y
muya	m u y a
muôi	m u ô i
muôn	m u ô n
muông	m u ô n g
muối	m u ố i
muốn	m u ố n
muống	m u ố n g
muốt	m u ố t
muồi	m u ồ i
muồm	m u ồ m
muồn	m u ồ n
muồng	m u ồ n g
muỗi	m u ỗ i
muỗm	m u ỗ m
muỗng	m u ỗ n g
muội	m u ộ i
muộn	m u ộ n
my	m y
myami	m y a m i
myanmar	m y a n m a r
mà	m à
mài	m à i
màn	m à n
màng	m à n g
mành	m à n h
mào	m à o
màu	m à u
mày	m à y
má	m á
mác	m á c
mác-ca	m á c c a
mác-ke-tinh	m á c k e t i n h
mác-két-tinh	m á c k é t t i n h
mác-kết-tinh	m á c k ế t t i n h
mác-ma	m á c m a
mác-tanh	m á c t a n h
mác-xít	m á c x í t
mách	m á c h
mái	m á i
mám	m á m
mán	m á n
máng	m á n g
mánh	m á n h
máo	m á o
mát	m á t
mát-tít	m á t t í t
mát-xa	m á t x a
máu	m á u
máy	m á y
mâm	m â m
mân	m â n
mâng	m â n g
mâp	m â p
mâu	m â u
mây	m â y
mã	m ã
mãi	m ã i
mãn	m ã n
mãng	m ã n g
mãnh	m ã n h
mão	m ã o
mè	m è
mèm	m è m
mèn	m è n
mèng	m è n g
mèo	m è o
mé	m é
méc	m é c
méc-xì	m é c x ì
mém	m é m
mén	m é n
méo	m é o
mép	m é p
mét	m é t
mét-tinh	m é t t i n h
mét-tra	m é t t r a
mét-xì	m é t x ì
mét-xì-a-văng	m é t x ì a v ă n g
méxico	m é x i c o
mê	m ê
mê-ga	m ê g a
mê-ga-mét	m ê g a m é t
mê-ga-oát	m ê g a o á t
mê-lô	m ê l ô
mê-măng-tô	m ê m ă n g t ô
mê-tan	m ê t a n
mê-tờ-rô	m ê t ờ r ô
mê-đi-a	m ê đ i a
mên	m ê n
mênh	m ê n h
mì	m ì
mìn	m ì n
mình	m ì n h
mí	m í
mía	m í a
mích	m í c h
mím	m í m
mính	m í n h
míp	m í p
mít	m í t
mít-tinh	m í t t i n h
míu	m í u
mò	m ò
mòi	m ò i
mòm	m ò m
mòn	m ò n
mòng	m ò n g
mó	m ó
móc	m ó c
mói	m ó i
móm	m ó m
món	m ó n
móng	m ó n g
móp	m ó p
mót	m ó t
mô	m ô
mô-bi-lét	m ô b i l é t
mô-bin	m ô b i n
mô-men	m ô m e n
mô-nô	m ô n ô
mô-nô-me	m ô n ô m e
mô-rát	m ô r á t
mô-típ	m ô t í p
mô-tô	m ô t ô
mô-tơ	m ô t ơ
mô-đen	m ô đ e n
mô-đéc	m ô đ é c
môi	m ô i
môi-răng	m ô i r ă n g
môi-vòm	m ô i v ò m
môm	m ô m
môn	m ô n
mông	m ô n g
mông-dao	m ô n g d a o
mông-ta	m ô n g t a
mông-ta-giơ	m ô n g t a g i ơ
môt	m ô t
mõ	m õ
mõi	m õ i
mõm	m õ m
mù	m ù
mù-soa	m ù s o a
mù-tạt	m ù t ạ t
mùa	m ù a
mùi	m ù i
mùi-soa	m ù i s o a
mùi-xoa	m ù i x o a
mùn	m ù n
mùng	m ù n g
mú	m ú
múa	m ú a
múc	m ú c
múi	m ú i
múm	m ú m
mún	m ú n
múp	m ú p
mút	m ú t
mút-cơ-tông	m ú t c ơ t ô n g
mút-xơ-lin	m ú t x ơ l i n
măm	m ă m
măm-den	m ă m d e n
măn	m ă n
măng	m ă n g
măng-ca	m ă n g c a
măng-cụt	m ă n g c ụ t
măng-sét	m ă n g s é t
măng-sông	m ă n g s ô n g
măng-tô	m ă n g t ô
măng-tôn	m ă n g t ô n
măng-đa	m ă n g đ a
măng-đô-lin	m ă n g đ ô l i n
mĩ	m ĩ
mĩm	m ĩ m
mũ	m ũ
mũi	m ũ i
mũm	m ũ m
mơ	m ơ
mơ-lông	m ơ l ô n g
mơ-nuy	m ơ n u y
mơ-nâm	m ơ n â m
mơ-nê	m ơ n ê
mơ-nơ	m ơ n ơ
mơi	m ơ i
mơn	m ơ n
mưa	m ư a
mưng	m ư n g
mưu	m ư u
mươi	m ư ơ i
mươn	m ư ơ n
mương	m ư ơ n g
mướn	m ư ớ n
mướp	m ư ớ p
mướt	m ư ớ t
mười	m ư ờ i
mườimây	m ư ờ i m â y
mườn	m ư ờ n
mường	m ư ờ n g
mưởi	m ư ở i
mưỡu	m ư ỡ u
mược	m ư ợ c
mượn	m ư ợ n
mượt	m ư ợ t
mạ	m ạ
mạc	m ạ c
mạc-cờ-rô	m ạ c c ờ r ô
mạc-ga-rít	m ạ c g a r í t
mạc-sê	m ạ c s ê
mạch	m ạ c h
mạch-lô	m ạ c h l ô
mại	m ạ i
mạn	m ạ n
mạng	m ạ n g
mạnh	m ạ n h
mạo	m ạ o
mạp	m ạ p
mạt	m ạ t
mạt-chược	m ạ t c h ư ợ c
mạy	m ạ y
mả	m ả
mải	m ả i
mảng	m ả n g
mảnh	m ả n h
mảy	m ả y
mấn	m ấ n
mấp	m ấ p
mất	m ấ t
mấu	m ấ u
mấy	m ấ y
mầm	m ầ m
mần	m ầ n
mầng	m ầ n g
mầu	m ầ u
mầy	m ầ y
mẩm	m ẩ m
mẩn	m ẩ n
mẩu	m ẩ u
mẩy	m ẩ y
mẫm	m ẫ m
mẫn	m ẫ n
mẫu	m ẫ u
mậm	m ậ m
mận	m ậ n
mập	m ậ p
mật	m ậ t
mậu	m ậ u
mậy	m ậ y
mắc	m ắ c
mắc-coọc	m ắ c c o ọ c
mắm	m ắ m
mắn	m ắ n
mắng	m ắ n g
mắt	m ắ t
mằn	m ằ n
mẳn	m ẳ n
mẵm	m ẵ m
mặc	m ặ c
mặn	m ặ n
mặt	m ặ t
mẹ	m ẹ
mẹc	m ẹ c
mẹo	m ẹ o
mẹp	m ẹ p
mẹt	m ẹ t
mẻ	m ẻ
mẻo	m ẻ o
mẽ	m ẽ
mế	m ế
mếch	m ế c h
mến	m ế n
mết	m ế t
mếu	m ế u
mề	m ề
mề-đay	m ề đ a y
mề-đay-dông	m ề đ a y d ô n g
mềm	m ề m
mền	m ề n
mền-đay	m ề n đ a y
mể	m ể
mễ	m ễ
mệ	m ệ
mệnh	m ệ n h
mệt	m ệ t
mỉ	m ỉ
mỉa	m ỉ a
mỉm	m ỉ m
mỉu	m ỉ u
mị	m ị
mịch	m ị c h
mịn	m ị n
mịnh	m ị n h
mịt	m ị t
mọ	m ọ
mọc	m ọ c
mọi	m ọ i
mọn	m ọ n
mọng	m ọ n g
mọp	m ọ p
mọt	m ọ t
mỏ	m ỏ
mỏ-lết	m ỏ l ế t
mỏi	m ỏ i
mỏm	m ỏ m
mỏng	m ỏ n g
mố	m ố
mốc	m ố c
mối	m ố i
mống	m ố n g
mốt	m ố t
mồ	m ồ
mồi	m ồ i
mồm	m ồ m
mồn	m ồ n
mồng	m ồ n g
mổ	m ổ
mổng	m ổ n g
mỗ	m ỗ
mỗi	m ỗ i
mộ	m ộ
mộc	m ộ c
mội	m ộ i
mộng	m ộ n g
một	m ộ t
mớ	m ớ
mới	m ớ i
mớm	m ớ m
mớn	m ớ n
mớp	m ớ p
mờ	m ờ
mời	m ờ i
mờm	m ờ m
mở	m ở
mởn	m ở n
mỡ	m ỡ
mợ	m ợ
mụ	m ụ
mục	m ụ c
mụi	m ụ i
mụn	m ụ n
mụp	m ụ p
mụt	m ụ t
mủ	m ủ
mủi	m ủ i
mủm	m ủ m
mủn	m ủ n
mủng	m ủ n g
mứa	m ứ a
mức	m ứ c
mứn	m ứ n
mứt	m ứ t
mứu	m ứ u
mừng	m ừ n g
mửa	m ử a
mửng	m ử n g
mự	m ự
mựa	m ự a
mực	m ự c
mỳ	m ỳ
mỵ	m ỵ
mỹ	m ỹ
n	n
na	n a
na-bi-ca	n a b i c a
na-di	n a d i
na-pan	n a p a n
na-tri	n a t r i
nadal	n a d a l
nagashima	n a g a s h i m a
nai	n a i
nail	n a i l
nakayama	n a k a y a m a
nam	n a m
nam-hạ	n a m h ạ
nam-kha	n a m k h a
nam-kì	n a m k ì
nam-sang	n a m s a n g
nam-đà	n a m đ à
nan	n a n
nancy	n a n c y
nang	n a n g
nanh	n a n h
nao	n a o
naomi	n a o m i
napoca	n a p o c a
napoli	n a p o l i
nara	n a r a
narita	n a r i t a
narnia	n a r n i a
nashang	n a s h a n g
natalie	n a t a l i e
natri	n a t r i
natsuki	n a t s u k i
nau	n a u
nax	n a x
naxăngno	n a x ă n g n o
nay	n a y
nazi	n a z i
ne	n e
nec	n e c
nederland	n e d e r l a n d
nem	n e m
nen	n e n
neo	n e o
neon	n e o n
nessie	n e s s i e
net	n e t
neville	n e v i l l e
new	n e w
newcastle	n e w c a s t l e
newman	n e w m a n
neworleans	n e w o r l e a n s
news	n e w s
newyork	n e w y o r k
next	n e x t
nga	n g a
ngai	n g a i
ngam	n g a m
ngan	n g a n
ngang	n g a n g
nganh	n g a n h
ngao	n g a o
ngau	n g a u
ngay	n g a y
nghe	n g h e
nghen	n g h e n
ngheo	n g h e o
nghi	n g h i
nghim	n g h i m
nghinh	n g h i n h
nghiu	n g h i u
nghiêm	n g h i ê m
nghiên	n g h i ê n
nghiêng	n g h i ê n g
nghiêp	n g h i ê p
nghiêu	n g h i ê u
nghiến	n g h i ế n
nghiền	n g h i ề n
nghiễm	n g h i ễ m
nghiễn	n g h i ễ n
nghiệm	n g h i ệ m
nghiện	n g h i ệ n
nghiệp	n g h i ệ p
nghiệt	n g h i ệ t
nghè	n g h è
nghèn	n g h è n
nghèo	n g h è o
nghé	n g h é
nghén	n g h é n
nghét	n g h é t
nghê	n g h ê
nghênh	n g h ê n h
nghêu	n g h ê u
nghì	n g h ì
nghìn	n g h ì n
nghí	n g h í
nghía	n g h í a
nghít	n g h í t
nghĩ	n g h ĩ
nghĩa	n g h ĩ a
nghĩnh	n g h ĩ n h
nghẹ	n g h ẹ
nghẹn	n g h ẹ n
nghẹo	n g h ẹ o
nghẹt	n g h ẹ t
nghẻn	n g h ẻ n
nghẻo	n g h ẻ o
nghẽn	n g h ẽ n
nghẽo	n g h ẽ o
nghếch	n g h ế c h
nghến	n g h ế n
nghề	n g h ề
nghền	n g h ề n
nghềnh	n g h ề n h
nghều	n g h ề u
nghể	n g h ể
nghển	n g h ể n
nghểnh	n g h ể n h
nghểu	n g h ể u
nghễ	n g h ễ
nghễnh	n g h ễ n h
nghễu	n g h ễ u
nghệ	n g h ệ
nghệch	n g h ệ c h
nghện	n g h ệ n
nghệt	n g h ệ t
nghệu	n g h ệ u
nghỉ	n g h ỉ
nghỉm	n g h ỉ m
nghỉn	n g h ỉ n
nghỉnh	n g h ỉ n h
nghỉu	n g h ỉ u
nghị	n g h ị
nghịch	n g h ị c h
nghịnh	n g h ị n h
nghịt	n g h ị t
nghịu	n g h ị u
ngo	n g o
ngoa	n g o a
ngoai	n g o a i
ngoam	n g o a m
ngoan	n g o a n
ngoang	n g o a n g
ngoao	n g o a o
ngoay	n g o a y
ngoc	n g o c
ngoe	n g o e
ngoem	n g o e m
ngoen	n g o e n
ngoeo	n g o e o
ngoi	n g o i
ngon	n g o n
ngong	n g o n g
ngoong	n g o o n g
ngoài	n g o à i
ngoàm	n g o à m
ngoác	n g o á c
ngoách	n g o á c h
ngoái	n g o á i
ngoáo	n g o á o
ngoáp	n g o á p
ngoáy	n g o á y
ngoã	n g o ã
ngoãn	n g o ã n
ngoèo	n g o è o
ngoé	n g o é
ngoém	n g o é m
ngoén	n g o é n
ngoéo	n g o é o
ngoét	n g o é t
ngoăn	n g o ă n
ngoăng	n g o ă n g
ngoạ	n g o ạ
ngoạc	n g o ạ c
ngoạch	n g o ạ c h
ngoại	n g o ạ i
ngoạm	n g o ạ m
ngoạn	n g o ạ n
ngoạp	n g o ạ p
ngoạt	n g o ạ t
ngoạy	n g o ạ y
ngoải	n g o ả i
ngoảm	n g o ả m
ngoảng	n g o ả n g
ngoảnh	n g o ả n h
ngoảy	n g o ả y
ngoắc	n g o ắ c
ngoắt	n g o ắ t
ngoằn	n g o ằ n
ngoằng	n g o ằ n g
ngoẳn	n g o ẳ n
ngoẳng	n g o ẳ n g
ngoẵng	n g o ẵ n g
ngoặc	n g o ặ c
ngoặp	n g o ặ p
ngoặt	n g o ặ t
ngoẹo	n g o ẹ o
ngoẻm	n g o ẻ m
ngoẻn	n g o ẻ n
ngoẻo	n g o ẻ o
ngu	n g u
ngun	n g u n
ngung	n g u n g
nguy	n g u y
nguyên	n g u y ê n
nguyền	n g u y ề n
nguyển	n g u y ể n
nguyễn	n g u y ễ n
nguyện	n g u y ệ n
nguyệt	n g u y ệ t
nguây	n g u â y
nguôi	n g u ô i
nguých	n g u ý c h
nguýt	n g u ý t
nguầy	n g u ầ y
nguẩy	n g u ẩ y
nguậy	n g u ậ y
nguếch	n g u ế c h
nguệch	n g u ệ c h
nguồi	n g u ồ i
nguồn	n g u ồ n
nguội	n g u ộ i
nguỳ	n g u ỳ
nguỵ	n g u ỵ
nguỷu	n g u ỷ u
ngà	n g à
ngài	n g à i
ngàm	n g à m
ngàn	n g à n
ngàng	n g à n g
ngành	n g à n h
ngào	n g à o
ngàu	n g à u
ngày	n g à y
ngác	n g á c
ngách	n g á c h
ngái	n g á i
ngám	n g á m
ngán	n g á n
ngáng	n g á n g
ngánh	n g á n h
ngáo	n g á o
ngáp	n g á p
ngát	n g á t
ngáu	n g á u
ngáy	n g á y
ngâm	n g â m
ngân	n g â n
ngâu	n g â u
ngây	n g â y
ngã	n g ã
ngãi	n g ã i
ngãng	n g ã n g
ngão	n g ã o
ngía	n g í a
ngò	n g ò
ngòi	n g ò i
ngòm	n g ò m
ngòn	n g ò n
ngòng	n g ò n g
ngó	n g ó
ngóc	n g ó c
ngóe	n g ó e
ngóeo	n g ó e o
ngói	n g ó i
ngóm	n g ó m
ngón	n g ó n
ngóng	n g ó n g
ngóp	n g ó p
ngót	n g ó t
ngô	n g ô
ngôi	n g ô i
ngôn	n g ô n
ngông	n g ô n g
ngõ	n g õ
ngõa	n g õ a
ngõi	n g õ i
ngõng	n g õ n g
ngù	n g ù
ngùi	n g ù i
ngùn	n g ù n
ngùng	n g ù n g
ngú	n g ú
ngúc	n g ú c
ngún	n g ú n
ngúng	n g ú n g
ngút	n g ú t
ngăm	n g ă m
ngăn	n g ă n
ngũ	n g ũ
ngũn	n g ũ n
ngũng	n g ũ n g
ngơ	n g ơ
ngơi	n g ơ i
ngơm	n g ơ m
ngơn	n g ơ n
ngư	n g ư
ngưa	n g ư a
ngưng	n g ư n g
ngưu	n g ư u
ngươi	n g ư ơ i
ngươn	n g ư ơ n
ngước	n g ư ớ c
ngườ	n g ư ờ
người	n g ư ờ i
ngường	n g ư ờ n g
ngưởng	n g ư ở n g
ngưỡng	n g ư ỡ n g
ngược	n g ư ợ c
ngượng	n g ư ợ n g
ngạ	n g ạ
ngạc	n g ạ c
ngạch	n g ạ c h
ngại	n g ạ i
ngạn	n g ạ n
ngạnh	n g ạ n h
ngạo	n g ạ o
ngạt	n g ạ t
ngả	n g ả
ngải	n g ả i
ngảng	n g ả n g
ngảnh	n g ả n h
ngảo	n g ả o
ngấc	n g ấ c
ngấm	n g ấ m
ngấn	n g ấ n
ngấp	n g ấ p
ngất	n g ấ t
ngấu	n g ấ u
ngấy	n g ấ y
ngầm	n g ầ m
ngần	n g ầ n
ngầu	n g ầ u
ngầy	n g ầ y
ngẩm	n g ẩ m
ngẩn	n g ẩ n
ngẩng	n g ẩ n g
ngẫm	n g ẫ m
ngẫn	n g ẫ n
ngẫu	n g ẫ u
ngậm	n g ậ m
ngận	n g ậ n
ngập	n g ậ p
ngật	n g ậ t
ngậu	n g ậ u
ngậy	n g ậ y
ngắc	n g ắ c
ngắm	n g ắ m
ngắn	n g ắ n
ngắt	n g ắ t
ngằn	n g ằ n
ngẳn	n g ẳ n
ngẳng	n g ẳ n g
ngẵng	n g ẵ n g
ngặt	n g ặ t
ngẹt	n g ẹ t
ngịu	n g ị u
ngọ	n g ọ
ngọa	n g ọ a
ngọc	n g ọ c
ngọn	n g ọ n
ngọng	n g ọ n g
ngọt	n g ọ t
ngỏ	n g ỏ
ngỏa	n g ỏ a
ngỏm	n g ỏ m
ngỏn	n g ỏ n
ngỏng	n g ỏ n g
ngố	n g ố
ngốc	n g ố c
ngốn	n g ố n
ngốt	n g ố t
ngồ	n g ồ
ngồi	n g ồ i
ngồm	n g ồ m
ngồn	n g ồ n
ngồng	n g ồ n g
ngổ	n g ổ
ngổm	n g ổ m
ngổn	n g ổ n
ngổng	n g ổ n g
ngỗ	n g ỗ
ngỗi	n g ỗ i
ngỗng	n g ỗ n g
ngộ	n g ộ
ngộc	n g ộ c
ngộn	n g ộ n
ngộp	n g ộ p
ngột	n g ộ t
ngớ	n g ớ
ngớn	n g ớ n
ngớp	n g ớ p
ngớt	n g ớ t
ngờ	n g ờ
ngời	n g ờ i
ngờm	n g ờ m
ngởn	n g ở n
ngỡ	n g ỡ
ngỡi	n g ỡ i
ngỡn	n g ỡ n
ngợ	n g ợ
ngợi	n g ợ i
ngợm	n g ợ m
ngợp	n g ợ p
ngụ	n g ụ
ngụa	n g ụ a
ngục	n g ụ c
ngụm	n g ụ m
ngụp	n g ụ p
ngụt	n g ụ t
ngụy	n g ụ y
ngủ	n g ủ
ngủi	n g ủ i
ngủm	n g ủ m
ngủn	n g ủ n
ngủng	n g ủ n g
ngứ	n g ứ
ngứa	n g ứ a
ngứng	n g ứ n g
ngứt	n g ứ t
ngừ	n g ừ
ngừa	n g ừ a
ngừng	n g ừ n g
ngửa	n g ử a
ngửi	n g ử i
ngửng	n g ử n g
ngữ	n g ữ
ngự	n g ự
ngựa	n g ự a
ngực	n g ự c
ngựu	n g ự u
nha	n h a
nhai	n h a i
nham	n h a m
nhan	n h a n
nhang	n h a n g
nhanh	n h a n h
nhao	n h a o
nhau	n h a u
nhay	n h a y
nhe	n h e
nhem	n h e m
nhen	n h e n
nheo	n h e o
nhi	n h i
nhin	n h i n
nhinh	n h i n h
nhiu	n h i u
nhiêm	n h i ê m
nhiên	n h i ê n
nhiêu	n h i ê u
nhiếc	n h i ế c
nhiếp	n h i ế p
nhiều	n h i ề u
nhiễm	n h i ễ m
nhiễn	n h i ễ n
nhiễu	n h i ễ u
nhiệm	n h i ệ m
nhiệt	n h i ệ t
nho	n h o
nhoai	n h o a i
nhoang	n h o a n g
nhoay	n h o a y
nhoe	n h o e
nhoen	n h o e n
nhoi	n h o i
nhom	n h o m
nhon	n h o n
nhong	n h o n g
nhoà	n h o à
nhoài	n h o à i
nhoàm	n h o à m
nhoàng	n h o à n g
nhoá	n h o á
nhoáng	n h o á n g
nhoáy	n h o á y
nhoè	n h o è
nhoèn	n h o è n
nhoé	n h o é
nhoét	n h o é t
nhoăn	n h o ă n
nhoạng	n h o ạ n g
nhoằng	n h o ằ n g
nhoẹt	n h o ẹ t
nhoẻn	n h o ẻ n
nhu	n h u
nhui	n h u i
nhum	n h u m
nhun	n h u n
nhung	n h u n g
nhuy	n h u y
nhuyên	n h u y ê n
nhuyễn	n h u y ễ n
nhuôm	n h u ô m
nhuần	n h u ầ n
nhuận	n h u ậ n
nhuế	n h u ế
nhuệ	n h u ệ
nhuốc	n h u ố c
nhuốm	n h u ố m
nhuồn	n h u ồ n
nhuộm	n h u ộ m
nhuỵ	n h u ỵ
nhà	n h à
nhài	n h à i
nhàm	n h à m
nhàn	n h à n
nhàng	n h à n g
nhành	n h à n h
nhào	n h à o
nhàu	n h à u
nhày	n h à y
nhá	n h á
nhác	n h á c
nhách	n h á c h
nhái	n h á i
nhám	n h á m
nháng	n h á n g
nhánh	n h á n h
nháo	n h á o
nháp	n h á p
nhát	n h á t
nháu	n h á u
nháy	n h á y
nhâm	n h â m
nhân	n h â n
nhâng	n h â n g
nhâu	n h â u
nhây	n h â y
nhã	n h ã
nhãi	n h ã i
nhãn	n h ã n
nhãng	n h ã n g
nhão	n h ã o
nhè	n h è
nhèm	n h è m
nhèn	n h è n
nhèo	n h è o
nhé	n h é
nhém	n h é m
nhén	n h é n
nhéo	n h é o
nhép	n h é p
nhét	n h é t
nhênh	n h ê n h
nhì	n h ì
nhìn	n h ì n
nhìu	n h ì u
nhí	n h í
nhía	n h í a
nhích	n h í c h
nhím	n h í m
nhín	n h í n
nhính	n h í n h
nhíp	n h í p
nhít	n h í t
nhíu	n h í u
nhò	n h ò
nhòa	n h ò a
nhòe	n h ò e
nhòm	n h ò m
nhòng	n h ò n g
nhó	n h ó
nhóa	n h ó a
nhóc	n h ó c
nhóe	n h ó e
nhói	n h ó i
nhóm	n h ó m
nhón	n h ó n
nhóng	n h ó n g
nhóp	n h ó p
nhót	n h ó t
nhô	n h ô
nhôi	n h ô i
nhôm	n h ô m
nhôn	n h ô n
nhông	n h ô n g
nhõ	n h õ
nhõi	n h õ i
nhõm	n h õ m
nhõn	n h õ n
nhõng	n h õ n g
nhù	n h ù
nhùi	n h ù i
nhùn	n h ù n
nhùng	n h ù n g
nhú	n h ú
nhúa	n h ú a
nhúc	n h ú c
nhúi	n h ú i
nhúm	n h ú m
nhún	n h ú n
nhúng	n h ú n g
nhút	n h ú t
nhăm	n h ă m
nhăn	n h ă n
nhăng	n h ă n g
nhĩ	n h ĩ
nhũ	n h ũ
nhũn	n h ũ n
nhũng	n h ũ n g
nhơ	n h ơ
nhơi	n h ơ i
nhơm	n h ơ m
nhơn	n h ơ n
như	n h ư
nhưng	n h ư n g
nhương	n h ư ơ n g
nhướn	n h ư ớ n
nhướng	n h ư ớ n g
nhường	n h ư ờ n g
nhưỡng	n h ư ỡ n g
nhược	n h ư ợ c
nhượng	n h ư ợ n g
nhạ	n h ạ
nhạc	n h ạ c
nhại	n h ạ i
nhạn	n h ạ n
nhạng	n h ạ n g
nhạnh	n h ạ n h
nhạo	n h ạ o
nhạp	n h ạ p
nhạt	n h ạ t
nhạy	n h ạ y
nhả	n h ả
nhải	n h ả i
nhảm	n h ả m
nhản	n h ả n
nhảnh	n h ả n h
nhảo	n h ả o
nhảu	n h ả u
nhảy	n h ả y
nhấc	n h ấ c
nhấm	n h ấ m
nhấn	n h ấ n
nhấp	n h ấ p
nhất	n h ấ t
nhấy	n h ấ y
nhầm	n h ầ m
nhần	n h ầ n
nhầu	n h ầ u
nhầy	n h ầ y
nhẩm	n h ẩ m
nhẩn	n h ẩ n
nhẩu	n h ẩ u
nhẩy	n h ẩ y
nhẫm	n h ẫ m
nhẫn	n h ẫ n
nhẫy	n h ẫ y
nhậm	n h ậ m
nhận	n h ậ n
nhập	n h ậ p
nhật	n h ậ t
nhật-bản	n h ậ t b ả n
nhậu	n h ậ u
nhậy	n h ậ y
nhắc	n h ắ c
nhắm	n h ắ m
nhắn	n h ắ n
nhắng	n h ắ n g
nhắp	n h ắ p
nhắt	n h ắ t
nhằm	n h ằ m
nhằn	n h ằ n
nhằng	n h ằ n g
nhẳn	n h ẳ n
nhẳng	n h ẳ n g
nhẵn	n h ẵ n
nhẵng	n h ẵ n g
nhặm	n h ặ m
nhặn	n h ặ n
nhặng	n h ặ n g
nhặt	n h ặ t
nhẹ	n h ẹ
nhẹm	n h ẹ m
nhẹn	n h ẹ n
nhẹo	n h ẹ o
nhẹp	n h ẹ p
nhẹt	n h ẹ t
nhẻ	n h ẻ
nhẻm	n h ẻ m
nhẻo	n h ẻ o
nhẽ	n h ẽ
nhẽo	n h ẽ o
nhếch	n h ế c h
nhếu	n h ế u
nhều	n h ề u
nhể	n h ể
nhểu	n h ể u
nhễ	n h ễ
nhệch	n h ệ c h
nhện	n h ệ n
nhệu	n h ệ u
nhỉ	n h ỉ
nhỉnh	n h ỉ n h
nhỉu	n h ỉ u
nhị	n h ị
nhịn	n h ị n
nhịp	n h ị p
nhịt	n h ị t
nhịu	n h ị u
nhọ	n h ọ
nhọc	n h ọ c
nhọn	n h ọ n
nhọt	n h ọ t
nhỏ	n h ỏ
nhỏm	n h ỏ m
nhỏn	n h ỏ n
nhỏng	n h ỏ n g
nhố	n h ố
nhốc	n h ố c
nhối	n h ố i
nhốn	n h ố n
nhốp	n h ố p
nhốt	n h ố t
nhồi	n h ồ i
nhồm	n h ồ m
nhồn	n h ồ n
nhồng	n h ồ n g
nhổ	n h ổ
nhổm	n h ổ m
nhổn	n h ổ n
nhổng	n h ổ n g
nhỗ	n h ỗ
nhội	n h ộ i
nhộn	n h ộ n
nhộng	n h ộ n g
nhột	n h ộ t
nhớ	n h ớ
nhớm	n h ớ m
nhớn	n h ớ n
nhớp	n h ớ p
nhớt	n h ớ t
nhờ	n h ờ
nhời	n h ờ i
nhờm	n h ờ m
nhờn	n h ờ n
nhở	n h ở
nhởi	n h ở i
nhởn	n h ở n
nhỡ	n h ỡ
nhỡn	n h ỡ n
nhợ	n h ợ
nhợn	n h ợ n
nhợp	n h ợ p
nhợt	n h ợ t
nhụ	n h ụ
nhụa	n h ụ a
nhục	n h ụ c
nhụi	n h ụ i
nhụng	n h ụ n g
nhụt	n h ụ t
nhụy	n h ụ y
nhủ	n h ủ
nhủi	n h ủ i
nhủn	n h ủ n
nhủng	n h ủ n g
nhứ	n h ứ
nhức	n h ứ c
nhứt	n h ứ t
nhừ	n h ừ
nhử	n h ử
nhửng	n h ử n g
nhữ	n h ữ
những	n h ữ n g
nhữu	n h ữ u
nhự	n h ự
nhựa	n h ự a
nhựt	n h ự t
nhựu	n h ự u
ni	n i
ni-cô-tin	n i c ô t i n
ni-ken	n i k e n
ni-lon	n i l o n
ni-lông	n i l ô n g
ni-na	n i n a
ni-nô	n i n ô
ni-trat	n i t r a t
ni-tơ	n i t ơ
ni-tơ-rat	n i t ơ r a t
ni-tơ-rát	n i t ơ r á t
ni-vô	n i v ô
nia	n i a
niagara	n i a g a r a
nicholas	n i c h o l a s
nick	n i c k
nicki	n i c k i
nicole	n i c o l e
nigeria	n i g e r i a
night	n i g h t
nile	n i l e
nin	n i n
ninh	n i n h
ninja	n i n j a
nino	n i n o
niu	n i u
niu-cát-xơn	n i u c á t x ơ n
niu-tơn	n i u t ơ n
niêm	n i ê m
niên	n i ê n
niêu	n i ê u
niếp	n i ế p
niết	n i ế t
niềm	n i ề m
niền	n i ề n
niềng	n i ề n g
niểu	n i ể u
niễn	n i ễ n
niễng	n i ễ n g
niễu	n i ễ u
niệm	n i ệ m
niện	n i ệ n
niệp	n i ệ p
niệt	n i ệ t
niệu	n i ệ u
no	n o
noa	n o a
noami	n o a m i
noel	n o e l
noi	n o i
nolting	n o l t i n g
nom	n o m
nom-mê	n o m m ê
nomo	n o m o
non	n o n
nong	n o n g
noong	n o o n g
noriko	n o r i k o
norodom	n o r o d o m
north	n o r t h
norwich	n o r w i c h
not	n o t
nottingham	n o t t i n g h a m
now	n o w
noãn	n o ã n
noản	n o ả n
npk	n p k
nu	n u
nua	n u a
nude	n u d e
nui	n u i
num	n u m
nung	n u n g
nuy	n u y
nuôi	n u ô i
nuông	n u ô n g
nuốc	n u ố c
nuối	n u ố i
nuốm	n u ố m
nuốt	n u ố t
nuộc	n u ộ c
nuột	n u ộ t
ny	n y
nylon	n y l o n
nà	n à
nà!	n à !
nài	n à i
nàm	n à m
nàn	n à n
nàng	n à n g
nành	n à n h
nào	n à o
nào...	n à o . . .
này	n à y
ná	n á
nác	n á c
nách	n á c h
nái	n á i
nám	n á m
nán	n á n
náng	n á n g
nánh	n á n h
náo	n á o
náp	n á p
náp-ta-len	n á p t a l e n
nát	n á t
nát-ri	n á t r i
náu	n á u
náy	n á y
nâm	n â m
nân	n â n
nâng	n â n g
nâu	n â u
nây	n â y
nã	n ã
nãi	n ã i
nãm	n ã m
nãn	n ã n
nãng	n ã n g
não	n ã o
nãy	n ã y
nè	n è
nèo	n è o
né	n é
ném	n é m
nén	n é n
néo	n é o
nép	n é p
nét	n é t
nê	n ê
nê-ông	n ê ô n g
nêm	n ê m
nên	n ê n
nênh	n ê n h
nêu	n ê u
nì	n ì
nình	n ì n h
ní	n í
nía	n í a
ních	n í c h
nín	n í n
nính	n í n h
níp	n í p
nít	n í t
níu	n í u
nò	n ò
nòi	n ò i
nòm	n ò m
nòng	n ò n g
nó	n ó
nóc	n ó c
nói	n ó i
nón	n ó n
nóng	n ó n g
nóp	n ó p
nót	n ó t
nô	n ô
nô-en	n ô e n
nô-vô-ca-in	n ô v ô c a i n
nôi	n ô i
nôm	n ô m
nôn	n ô n
nông	n ô n g
nõ	n õ
nõn	n õ n
nùi	n ù i
nùn	n ù n
nùng	n ù n g
nú	n ú
núa	n ú a
núc	n ú c
núi	n ú i
núm	n ú m
núng	n ú n g
núp	n ú p
nút	n ú t
năm	n ă m
nămg	n ă m g
năn	n ă n
năng	n ă n g
nĩa	n ĩ a
nũm	n ũ m
nũng	n ũ n g
nơ	n ơ
nơ-ron	n ơ r o n
nơ-tron	n ơ t r o n
nơ-tơ-rôn	n ơ t ơ r ô n
nơ-tờ-ron	n ơ t ờ r o n
nơi	n ơ i
nơm	n ơ m
nư	n ư
nưa	n ư a
nưng	n ư n g
nương	n ư ơ n g
nước	n ư ớ c
nước:	n ư ớ c :
nướng	n ư ớ n g
nướu	n ư ớ u
nườm	n ư ờ m
nường	n ư ờ n g
nược	n ư ợ c
nượp	n ư ợ p
nạ	n ạ
nạc	n ạ c
nạch	n ạ c h
nại	n ạ i
nạm	n ạ m
nạn	n ạ n
nạng	n ạ n g
nạnh	n ạ n h
nạo	n ạ o
nạp	n ạ p
nạt	n ạ t
nạy	n ạ y
nả	n ả
nải	n ả i
nảm	n ả m
nản	n ả n
nảo	n ả o
nảy	n ả y
nấc	n ấ c
nấm	n ấ m
nấn	n ấ n
nấng	n ấ n g
nấp	n ấ p
nấu	n ấ u
nấy	n ấ y
nầm	n ầ m
nần	n ầ n
nầy	n ầ y
nẩy	n ẩ y
nẫm	n ẫ m
nẫn	n ẫ n
nẫng	n ẫ n g
nẫu	n ẫ u
nẫy	n ẫ y
nậm	n ậ m
nậng	n ậ n g
nập	n ậ p
nật	n ậ t
nậu	n ậ u
nậy	n ậ y
nắc	n ắ c
nắm	n ắ m
nắn	n ắ n
nắng	n ắ n g
nắp	n ắ p
nằm	n ằ m
nằn	n ằ n
nằng	n ằ n g
nẵng	n ẵ n g
nặc	n ặ c
nặn	n ặ n
nặng	n ặ n g
nẹ	n ẹ
nẹp	n ẹ p
nẹt	n ẹ t
nẻ	n ẻ
nẻo	n ẻ o
nếm	n ế m
nến	n ế n
nếp	n ế p
nết	n ế t
nếu	n ế u
nề	n ề
nền	n ề n
nể	n ể
nễ	n ễ
nệ	n ệ
nệm	n ệ m
nện	n ệ n
nệp	n ệ p
nỉ	n ỉ
nị	n ị
nịch	n ị c h
nịnh	n ị n h
nịt	n ị t
nịu	n ị u
nọ	n ọ
nọa	n ọ a
nọc	n ọ c
nọi	n ọ i
nọn	n ọ n
nọng	n ọ n g
nọt	n ọ t
nỏ	n ỏ
nỏi	n ỏ i
nỏm	n ỏ m
nố	n ố
nốc	n ố c
nốc-ao	n ố c a o
nối	n ố i
nống	n ố n g
nốp	n ố p
nốt	n ố t
nốt-xê	n ố t x ê
nồ	n ồ
nồi	n ồ i
nồm	n ồ m
nồng	n ồ n g
nổ	n ổ
nổi	n ổ i
nổng	n ổ n g
nỗ	n ỗ
nỗi	n ỗ i
nỗng	n ỗ n g
nộ	n ộ
nộc	n ộ c
nội	n ộ i
nộm	n ộ m
nộn	n ộ n
nộp	n ộ p
nột	n ộ t
nớ	n ớ
nới	n ớ i
nớp	n ớ p
nớt	n ớ t
nờ	n ờ
nờm	n ờ m
nở	n ở
nỡ	n ỡ
nỡm	n ỡ m
nợ	n ợ
nợp	n ợ p
nụ	n ụ
nục	n ụ c
nụy	n ụ y
nủa	n ủ a
nứ	n ứ
nứa	n ứ a
nức	n ứ c
nứng	n ứ n g
nứt	n ứ t
nừng	n ừ n g
nử	n ử
nửa	n ử a
nữ	n ữ
nữa	n ữ a
nữanh	n ữ a n h
nữu	n ữ u
nự	n ự
nực	n ự c
nựng	n ự n g
o	o
o-bo	o b o
o-don	o d o n
o-xi	o x i
o-xi-hoá	o x i h o á
o-xy	o x y
o-xít	o x í t
o-xýt	o x ý t
oa	o a
oa-lít	o a l í t
oai	o a i
oak	o a k
oan	o a n
oang	o a n g
oanh	o a n h
obama	o b a m a
obi	o b i
obon	o b o n
odyssey	o d y s s e y
oe	o e
oeng	o e n g
oeo	o e o
of	o f
off	o f f
office	o f f i c e
offline	o f f l i n e
ogihara	o g i h a r a
ohno	o h n o
oi	o i
ok	o k
oka	o k a
okada	o k a d a
okamoto	o k a m o t o
okawa	o k a w a
old	o l d
oldman	o l d m a n
olga	o l g a
oliver	o l i v e r
olympic	o l y m p i c
om	o m
on	o n
one	o n e
ong	o n g
online	o n l i n e
oong	o o n g
opec	o p e c
open	o p e n
opera	o p e r a
option	o p t i o n
options	o p t i o n s
or	o r
orange	o r a n g e
organization	o r g a n i z a t i o n
orhan	o r h a n
orlando	o r l a n d o
osaka	o s a k a
oscar	o s c a r
oser	o s e r
otc	o t c
outback	o u t b a c k
outlook	o u t l o o k
owen	o w e n
oxi	o x i
oxy	o x y
oà	o à
oài	o à i
oàm	o à m
oàng	o à n g
oành	o à n h
oác	o á c
oách	o á c h
oái	o á i
oán	o á n
oánh	o á n h
oáp	o á p
oát	o á t
oát-kế	o á t k ế
oèo	o è o
oé	o é
oéc	o é c
oóc	o ó c
oóc-gan	o ó c g a n
oóc-giơ	o ó c g i ơ
oăm	o ă m
oăn	o ă n
oăng	o ă n g
oạc	o ạ c
oạch	o ạ c h
oại	o ạ i
oạp	o ạ p
oạt	o ạ t
oải	o ả i
oản	o ả n
oắt	o ắ t
oằn	o ằ n
oẳn	o ẳ n
oẳng	o ẳ n g
oặt	o ặ t
oẹ	o ẹ
oẻ	o ẻ
p	p
pa	p a
pa-cô	p a c ô
pa-dí	p a d í
pa-leng	p a l e n g
pa-lét	p a l é t
pa-lăng	p a l ă n g
pa-lơ-tô	p a l ơ t ô
pa-nen	p a n e n
pa-noong	p a n o o n g
pa-nô	p a n ô
pa-pi-ê	p a p i ê
pa-ra-bon	p a r a b o n
pa-ra-bôn	p a r a b ô n
pa-ra-phin	p a r a p h i n
pa-tanh	p a t a n h
pa-ti-nê	p a t i n ê
pa-tê	p a t ê
pa-tăng	p a t ă n g
pa-đờ-xuy	p a đ ờ x u y
paa	p a a
packs	p a c k s
padu	p a d u
pai	p a i
paige	p a i g e
pair	p a i r
pakistan	p a k i s t a n
palm	p a l m
pamuk	p a m u k
pan	p a n
pan-ca	p a n c a
pan-me	p a n m e
pan-tô	p a n t ô
pang	p a n g
panh	p a n h
panh-xô	p a n h x ô
pao	p a o
paparazzi	p a p a r a z z i
paradise	p a r a d i s e
pari	p a r i
paris	p a r i s
park	p a r k
partition	p a r t i t i o n
pass	p a s s
password	p a s s w o r d
patrick	p a t r i c k
paul	p a u l
paypass	p a y p a s s
pe	p e
pe-man-ga-nát	p e m a n g a n á t
pe-sê-ta	p e s ê t a
pearson	p e a r s o n
pedro	p e d r o
peggy	p e g g y
pen	p e n
pen-cát-xi-lát	p e n c á t x i l á t
pen-xơ	p e n x ơ
penalty	p e n a l t y
penn	p e n n
penny	p e n n y
pentax	p e n t a x
penthouse	p e n t h o u s e
pentium	p e n t i u m
pep	p e p
pepe	p e p e
pepsi	p e p s i
pepto	p e p t o
perejil	p e r e j i l
perez	p e r e z
perin	p e r i n
perrotta	p e r r o t t a
personalize	p e r s o n a l i z e
peso	p e s o
petaling	p e t a l i n g
peter	p e t e r
petroleum	p e t r o l e u m
petrolimex	p e t r o l i m e x
pha	p h a
pha-lê	p h a l ê
pha-ra-đây	p h a r a đ â y
pha-đinh	p h a đ i n h
phai	p h a i
phan	p h a n
phang	p h a n g
phanh	p h a n h
phantom	p h a n t o m
phao	p h a o
phau	p h a u
phay	p h a y
phe	p h e
phe-pa	p h e p a
phen	p h e n
pheng	p h e n g
pheo	p h e o
phi	p h i
phi-di-đe	p h i d i đ e
phi-dê	p h i d ê
phi-la-tốp	p h i l a t ố p
phi-lao	p h i l a o
phi-lu	p h i l u
phi-lê	p h i l ê
phi-lô-dốp	p h i l ô d ố p
phi-nan	p h i n a n
phi-năng	p h i n ă n g
phil	p h i l
philippines	p h i l i p p i n e s
phillipines	p h i l l i p i n e s
phim	p h i m
phin	p h i n
phinh	p h i n h
phiu	p h i u
phiên	p h i ê n
phiêng	p h i ê n g
phiêu	p h i ê u
phiếm	p h i ế m
phiến	p h i ế n
phiết	p h i ế t
phiếu	p h i ế u
phiền	p h i ề n
phiểu	p h i ể u
phiện	p h i ệ n
phiệt	p h i ệ t
phiệu	p h i ệ u
pho	p h o
pho-mát	p h o m á t
pho-ton	p h o t o n
pho-xép	p h o x é p
phoenix	p h o e n i x
phoi	p h o i
phom	p h o m
phone	p h o n e
phong	p h o n g
phong-tên	p h o n g t ê n
photos	p h o t o s
photoshop	p h o t o s h o p
phoóc	p h o ó c
phoóc-môn	p h o ó c m ô n
phoóc-xép	p h o ó c x é p
phoóc-xếp	p h o ó c x ế p
phu	p h u
phu-la	p h u l a
phu-lít	p h u l í t
phua	p h u a
phui	p h u i
phun	p h u n
phung	p h u n g
phuy	p h u y
phà	p h à
phài	p h à i
phàm	p h à m
phàn	p h à n
phàng	p h à n g
phành	p h à n h
phào	p h à o
phá	p h á
phác	p h á c
phách	p h á c h
phái	p h á i
phán	p h á n
pháo	p h á o
pháp	p h á p
phát	p h á t
phát-xít	p h á t x í t
pháy	p h á y
phâm	p h â m
phân	p h â n
phây	p h â y
phãn	p h ã n
phè	p h è
phèn	p h è n
phèng	p h è n g
phèo	p h è o
phé	p h é
phéc	p h é c
phéc-mơ-tuya	p h é c m ơ t u y a
phéng	p h é n g
phép	p h é p
phét	p h é t
phê	p h ê
phê-non	p h ê n o n
phê-nô-men	p h ê n ô m e n
phên	p h ê n
phênh	p h ê n h
phêu	p h ê u
phì	p h ì
phìa	p h ì a
phìn	p h ì n
phình	p h ì n h
phí	p h í
phía	p h í a
phích	p h í c h
phím	p h í m
phính	p h í n h
phít	p h í t
phò	p h ò
phòi	p h ò i
phòm	p h ò m
phòng	p h ò n g
phó	p h ó
phó-mát	p h ó m á t
phóc	p h ó c
phóng	p h ó n g
phót	p h ó t
phô	p h ô
phô-mai	p h ô m a i
phô-nô	p h ô n ô
phô-tô	p h ô t ô
phô-tô-co-pi	p h ô t ô c o p i
phô-tô-cóp-pi	p h ô t ô c ó p p i
phô-tô-cô-pi	p h ô t ô c ô p i
phô-tơi	p h ô t ơ i
phôi	p h ô i
phôm	p h ô m
phôn	p h ô n
phông	p h ô n g
phông-xon-ne	p h ô n g x o n n e
phông-đa-tơ	p h ô n g đ a t ơ
phù	p h ù
phùa	p h ù a
phùn	p h ù n
phùng	p h ù n g
phú	p h ú
phúc	p h ú c
phún	p h ú n
phúng	p h ú n g
phút	p h ú t
phăm	p h ă m
phăn	p h ă n
phăng	p h ă n g
phĩnh	p h ĩ n h
phũ	p h ũ
phơ	p h ơ
phơi	p h ơ i
phơn	p h ơ n
phưng	p h ư n g
phương	p h ư ơ n g
phước	p h ư ớ c
phướn	p h ư ớ n
phướng	p h ư ớ n g
phường	p h ư ờ n g
phưởng	p h ư ở n g
phưỡn	p h ư ỡ n
phược	p h ư ợ c
phượng	p h ư ợ n g
phượt	p h ư ợ t
phượu	p h ư ợ u
phạ	p h ạ
phạc	p h ạ c
phạch	p h ạ c h
phạm	p h ạ m
phạm-nhe	p h ạ m n h e
phạn	p h ạ n
phạng	p h ạ n g
phạo	p h ạ o
phạp	p h ạ p
phạt	p h ạ t
phả	p h ả
phải	p h ả i
phản	p h ả n
phảng	p h ả n g
phảy	p h ả y
phấn	p h ấ n
phấp	p h ấ p
phất	p h ấ t
phấu	p h ấ u
phầm	p h ầ m
phần	p h ầ n
phầu	p h ầ u
phẩm	p h ẩ m
phẩn	p h ẩ n
phẩu	p h ẩ u
phẩy	p h ẩ y
phẫn	p h ẫ n
phẫu	p h ẫ u
phận	p h ậ n
phập	p h ậ p
phật	p h ậ t
phắc	p h ắ c
phắc-tuya	p h ắ c t u y a
phắc-xi-min	p h ắ c x i m i n
phắn	p h ắ n
phắp	p h ắ p
phắt	p h ắ t
phẳng	p h ẳ n g
phặng	p h ặ n g
phẹc-mơ-tuya	p h ẹ c m ơ t u y a
phẹt	p h ẹ t
phế	p h ế
phếch	p h ế c h
phết	p h ế t
phếu	p h ế u
phề	p h ề
phềnh	p h ề n h
phều	p h ề u
phễn	p h ễ n
phễu	p h ễ u
phệ	p h ệ
phệnh	p h ệ n h
phệt	p h ệ t
phệu	p h ệ u
phỉ	p h ỉ
phỉnh	p h ỉ n h
phị	p h ị
phịa	p h ị a
phịch	p h ị c h
phịt	p h ị t
phịu	p h ị u
phọc	p h ọ c
phọng	p h ọ n g
phọp	p h ọ p
phọt	p h ọ t
phỏng	p h ỏ n g
phố	p h ố
phốc	p h ố c
phối	p h ố i
phốp	p h ố p
phốt	p h ố t
phốt-pho	p h ố t p h o
phốt-pho-rít	p h ố t p h o r í t
phốt-phát	p h ố t p h á t
phồ	p h ồ
phồm	p h ồ m
phồn	p h ồ n
phồng	p h ồ n g
phổ	p h ổ
phổi	p h ổ i
phổng	p h ổ n g
phỗng	p h ỗ n g
phộc	p h ộ c
phộng	p h ộ n g
phớ	p h ớ
phới	p h ớ i
phớn	p h ớ n
phớt	p h ớ t
phờ	p h ờ
phờ-răng	p h ờ r ă n g
phời	p h ờ i
phở	p h ở
phởn	p h ở n
phỡn	p h ỡ n
phụ	p h ụ
phục	p h ụ c
phụng	p h ụ n g
phụp	p h ụ p
phụt	p h ụ t
phủ	p h ủ
phủi	p h ủ i
phủng	p h ủ n g
phứa	p h ứ a
phức	p h ứ c
phứt	p h ứ t
phừn	p h ừ n
phừng	p h ừ n g
phữu	p h ữ u
phựa	p h ự a
phực	p h ự c
phựt	p h ự t
pi	p i
pi-a-nô	p i a n ô
pi-gia-ma	p i g i a m a
pi-lốt	p i l ố t
pi-nhê	p i n h ê
pi-ni-xi-lin	p i n i x i l i n
pi-pét	p i p é t
pi-ra-mi-đông	p i r a m i đ ô n g
pi-rin	p i r i n
pi-rít	p i r í t
piaggio	p i a g g i o
piano	p i a n o
picaso	p i c a s o
piccadilly	p i c c a d i l l y
picture	p i c t u r e
pictures	p i c t u r e s
piero	p i e r o
pierre	p i e r r e
pimlico	p i m l i c o
pin	p i n
pinewood	p i n e w o o d
ping-pong	p i n g p o n g
ping-pông	p i n g p ô n g
pinh-pông	p i n h p ô n g
pique	p i q u e
pitt	p i t t
pizza	p i z z a
piêu	p i ê u
plan	p l a n
plastic	p l a s t i c
play	p l a y
player	p l a y e r
plaza	p l a z a
pleiku	p l e i k u
plus	p l u s
plymouth	p l y m o u t h
po-si-tron	p o s i t r o n
poa-nha	p o a n h a
poa-nhê	p o a n h ê
podium	p o d i u m
polo	p o l o
pom	p o m
pom-mát	p o m m á t
pop	p o p
portland	p o r t l a n d
pos	p o s
pose	p o s e
posh	p o s h
post	p o s t
potter	p o t t e r
pound	p o u n d
power	p o w e r
poznań	p o z n a ń
poọng	p o ọ n g
premier	p r e m i e r
premiership	p r e m i e r s h i p
premium	p r e m i u m
preston	p r e s t o n
pretty	p r e t t y
preview	p r e v i e w
prius	p r i u s
propane	p r o p a n e
properties	p r o p e r t i e s
protection	p r o t e c t i o n
protein	p r o t e i n
provence	p r o v e n c e
proxy	p r o x y
pstn	p s t n
pu	p u
pu-li	p u l i
pua	p u a
public	p u b l i c
pudding	p u d d i n g
pui	p u i
purchase	p u r c h a s e
puri	p u r i
push	p u s h
putin	p u t i n
puy-lơ-ve	p u y l ơ v e
puốc	p u ố c
puốc-boa	p u ố c b o a
puốc-xăng	p u ố c x ă n g
puộc	p u ộ c
pà	p à
pài	p à i
pàng	p à n g
pành	p à n h
pác	p á c
pác-lơ	p á c l ơ
pác-panh	p á c p a n h
pác-séc	p á c s é c
pán	p á n
páp	p á p
pát	p á t
pát-xơ-po	p á t x ơ p o
pâu	p â u
péc-lông	p é c l ô n g
péc-mi	p é c m i
péc-măng-ga-nát	p é c m ă n g g a n á t
péo	p é o
pê	p ê
pê-nan-ti	p ê n a n t i
pê-ni-xi-lin	p ê n i x i l i n
pê-ri-xoa	p ê r i x o a
pê-rít-xoa	p ê r í t x o a
pê-sô	p ê s ô
pê-đa-lét	p ê đ a l é t
pê-đa-lô	p ê đ a l ô
pê-đan	p ê đ a n
pí	p í
píc-níc	p í c n í c
pích	p í c h
pích-kê	p í c h k ê
pích-ních	p í c h n í c h
píp	p í p
pít	p í t
pít-tông	p í t t ô n g
pò	p ò
pót	p ó t
pô	p ô
pô-dơ-mét	p ô d ơ m é t
pô-li-me	p ô l i m e
pô-li-vi-ta-min	p ô l i v i t a m i n
pô-li-ê-ti-len	p ô l i ê t i l e n
pô-pe-lin	p ô p e l i n
pô-pơ-lin	p ô p ơ l i n
pô-rơ-tít	p ô r ơ t í t
pô-sét	p ô s é t
pô-tát	p ô t á t
pô-xi-ông	p ô x i ô n g
pôn	p ô n
pôông	p ô ô n g
păng!	p ă n g !
păng-túp	p ă n g t ú p
păng-xê	p ă n g x ê
pơ	p ơ
pơ-luya	p ơ l u y a
pơ-mu	p ơ m u
pơng	p ơ n g
pươi	p ư ơ i
pạ	p ạ
pả	p ả
pải	p ả i
pấc	p ấ c
pắc	p ắ c
pằn	p ằ n
pẹc	p ẹ c
pẹc-xin	p ẹ c x i n
pẻ	p ẻ
pờ	p ờ
pờ-rô-gờ-ram	p ờ r ô g ờ r a m
pụa	p ụ a
qatar	q a t a r
qua	q u a
quai	q u a i
quan	q u a n
quang	q u a n g
quanh	q u a n h
quao	q u a o
quau	q u a u
quay	q u a y
que	q u e
quen	q u e n
queng	q u e n g
queo	q u e o
qui	q u i
qui-lát	q u i l á t
quoàng	q u o à n g
quoạng	q u o ạ n g
quoắt	q u o ắ t
quuyết	q u u y ế t
quy	q u y
quy-lát	q u y l á t
quy-nin	q u y n i n
quynh	q u y n h
quyên	q u y ê n
quyến	q u y ế n
quyết	q u y ế t
quyền	q u y ề n
quyển	q u y ể n
quyện	q u y ệ n
quyệt	q u y ệ t
quà	q u à
quài	q u à i
quàn	q u à n
quàng	q u à n g
quành	q u à n h
quào	q u à o
quàu	q u à u
quày	q u à y
quá	q u á
quác	q u á c
quách	q u á c h
quái	q u á i
quán	q u á n
quáng	q u á n g
quánh	q u á n h
quáo	q u á o
quát	q u á t
quáu	q u á u
quáy	q u á y
quân	q u â n
quâng	q u â n g
quây	q u â y
quãng	q u ã n g
què	q u è
quèn	q u è n
quèo	q u è o
qué	q u é
quéc	q u é c
quén	q u é n
quéo	q u é o
quét	q u é t
quê	q u ê
quên	q u ê n
quì	q u ì
quình	q u ì n h
quí	q u í
quích	q u í c h
quít	q u í t
quý	q u ý
quých	q u ý c h
quýnh	q u ý n h
quýt	q u ý t
quýu	q u ý u
quăm	q u ă m
quăn	q u ă n
quăng	q u ă n g
quĩ	q u ĩ
quơ	q u ơ
quạ	q u ạ
quạc	q u ạ c
quạch	q u ạ c h
quại	q u ạ i
quạng	q u ạ n g
quạnh	q u ạ n h
quạo	q u ạ o
quạt	q u ạ t
quạu	q u ạ u
quạy	q u ạ y
quả	q u ả
quải	q u ả i
quản	q u ả n
quảng	q u ả n g
quảy	q u ả y
quấc	q u ấ c
quấn	q u ấ n
quất	q u ấ t
quấy	q u ấ y
quần	q u ầ n
quầng	q u ầ n g
quầy	q u ầ y
quẩn	q u ẩ n
quẩng	q u ẩ n g
quẩy	q u ẩ y
quẫn	q u ẫ n
quẫy	q u ẫ y
quận	q u ậ n
quật	q u ậ t
quậy	q u ậ y
quắc	q u ắ c
quắm	q u ắ m
quắn	q u ắ n
quắp	q u ắ p
quắt	q u ắ t
quằm	q u ằ m
quằn	q u ằ n
quẳm	q u ẳ m
quẳng	q u ẳ n g
quặc	q u ặ c
quặm	q u ặ m
quặn	q u ặ n
quặng	q u ặ n g
quặp	q u ặ p
quặt	q u ặ t
quẹn	q u ẹ n
quẹo	q u ẹ o
quẹt	q u ẹ t
quẻ	q u ẻ
quẽ	q u ẽ
quế	q u ế
quếch	q u ế c h
quến	q u ế n
quếnh	q u ế n h
quết	q u ế t
quếu	q u ế u
quề	q u ề
quềnh	q u ề n h
quều	q u ề u
quệ	q u ệ
quệch	q u ệ c h
quện	q u ệ n
quệnh	q u ệ n h
quệt	q u ệ t
quỉ	q u ỉ
quị	q u ị
quịt	q u ị t
quọ	q u ọ
quốc	q u ố c
quớ	q u ớ
quới	q u ớ i
quớt	q u ớ t
quờ	q u ờ
quờn	q u ờ n
quở	q u ở
quỳ	q u ỳ
quỳnh	q u ỳ n h
quỵ	q u ỵ
quỵp	q u ỵ p
quỵt	q u ỵ t
quỷ	q u ỷ
quỷnh	q u ỷ n h
quỹ	q u ỹ
qùy	q ù y
qúy	q ú y
qũy	q ũ y
qụy	q ụ y
r	r
ra	r a
ra-gu	r a g u
ra-két	r a k é t
ra-lăng-ti	r a l ă n g t i
ra-đa	r a đ a
ra-đi	r a đ i
ra-đi-an	r a đ i a n
ra-đi-om	r a đ i o m
ra-đi-um	r a đ i u m
ra-đi-ô	r a đ i ô
ra-đê	r a đ ê
ra-đô	r a đ ô
rabbani	r a b b a n i
racer	r a c e r
rachel	r a c h e l
racing	r a c i n g
radar	r a d a r
radio	r a d i o
rafa	r a f a
rafael	r a f a e l
rai	r a i
rail	r a i l
ram	r a m
ramen	r a m e n
ran	r a n
ran-đơ	r a n đ ơ
rang	r a n g
ranh	r a n h
rao	r a o
rap	r a p
raphael	r a p h a e l
ratrầm	r a t r ầ m
rau	r a u
ray	r a y
ray-ông	r a y ô n g
raya	r a y a
rayman	r a y m a n
rađiô	r a đ i ô
re	r e
real	r e a l
really	r e a l l y
rectangle	r e c t a n g l e
reed	r e e d
refurbished	r e f u r b i s h e d
regent	r e g e n t
region	r e g i o n
rem	r e m
reminders	r e m i n d e r s
remote	r e m o t e
removal	r e m o v a l
remy	r e m y
ren	r e n
rename	r e n a m e
reng	r e n g
renta	r e n t a
reo	r e o
resort	r e s o r t
respiratory	r e s p i r a t o r y
reynolds	r e y n o l d s
rhone	r h o n e
ri	r i
ri-an	r i a n
ri-vê	r i v ê
ri-đô	r i đ ô
ria	r i a
rica	r i c a
richard	r i c h a r d
richter	r i c h t e r
ricoh	r i c o h
rihanna	r i h a n n a
rim	r i m
rin	r i n
rinaldi	r i n a l d i
ringgit	r i n g g i t
rinh	r i n h
rinh-ghít	r i n h g h í t
rinh-tê	r i n h t ê
rio	r i o
rios	r i o s
riu	r i u
rià	r i à
riên	r i ê n
riêng	r i ê n g
riêu	r i ê u
riếp	r i ế p
riết	r i ế t
riếu	r i ế u
riềm	r i ề m
riềng	r i ề n g
riễu	r i ễ u
riệt	r i ệ t
ro	r o
roa	r o a
roadshow	r o a d s h o w
robben	r o b b e n
robert	r o b e r t
roberts	r o b e r t s
robinson	r o b i n s o n
robocon	r o b o c o n
robot	r o b o t
robusta	r o b u s t a
rock	r o c k
rockefeller	r o c k e f e l l e r
rocker	r o c k e r
rocket	r o c k e t
rocky	r o c k y
rodrigo	r o d r i g o
rogers	r o g e r s
roi	r o i
rolex	r o l e x
rom	r o m
roma	r o m a
romania	r o m a n i a
rome	r o m e
ron	r o n
rong	r o n g
room	r o o m
rooney	r o o n e y
roong	r o o n g
root	r o o t
rootkit	r o o t k i t
rose	r o s e
rosemead	r o s e m e a d
roy	r o y
roàn	r o à n
roàng	r o à n g
roòng	r o ò n g
roạt	r o ạ t
ru	r u
ru-bi	r u b i
ru-lét	r u l é t
ru-lô	r u l ô
ru-pi	r u p i
ru-pi-a	r u p i a
rua	r u a
ruby	r u b y
rui	r u i
rum	r u m
rum-ba	r u m b a
rumi	r u m i
run	r u n
rung	r u n g
rupiah	r u p i a h
russell	r u s s e l l
ruy-băng	r u y b ă n g
ruy-bờ-rích	r u y b ờ r í c h
ruê	r u ê
ruôn	r u ô n
ruốc	r u ố c
ruối	r u ố i
ruốt	r u ố t
ruồi	r u ồ i
ruồng	r u ồ n g
ruổi	r u ổ i
ruỗng	r u ỗ n g
ruộc	r u ộ c
ruộm	r u ộ m
ruộng	r u ộ n g
ruột	r u ộ t
ry	r y
ryan	r y a n
rà	r à
rài	r à i
ràn	r à n
ràng	r à n g
rành	r à n h
rào	r à o
rày	r à y
rá	r á
rác	r á c
rách	r á c h
rái	r á i
rám	r á m
rán	r á n
ráng	r á n g
ráo	r á o
ráp	r á p
rát	r á t
rát-tê	r á t t ê
ráu	r á u
ráy	r á y
râm	r â m
rân	r â n
râu	r â u
rây	r â y
rã	r ã
rãi	r ã i
rãnh	r ã n h
rão	r ã o
rãy	r ã y
rè	r è
rèm	r è m
rèn	r è n
rèo	r è o
ré	r é
rén	r é n
réo	r é o
rét	r é t
rê	r ê
rê-vây	r ê v â y
rêm	r ê m
rên	r ê n
rêu	r ê u
rì	r ì
rìa	r ì a
rình	r ì n h
rìu	r ì u
rí	r í
rích	r í c h
rích-te	r í c h t e
rím	r í m
ríp-pê	r í p p ê
rít	r í t
ríu	r í u
rò	r ò
ròi	r ò i
ròm	r ò m
ròn	r ò n
ròng	r ò n g
ró	r ó
róc	r ó c
rói	r ó i
róm	r ó m
rón	r ó n
róng	r ó n g
rót	r ó t
rô	r ô
rô-bi-nê	r ô b i n ê
rô-bô-tích	r ô b ô t í c h
rô-bốt	r ô b ố t
rô-nê-ô	r ô n ê ô
rô-ti	r ô t i
rô-to	r ô t o
rô-đa	r ô đ a
rô-đê	r ô đ ê
rôi	r ô i
rôm	r ô m
rôn	r ô n
rông	r ô n g
rông-đanh	r ô n g đ a n h
rông-đen	r ô n g đ e n
rông-đô	r ô n g đ ô
rông-đền	r ô n g đ ề n
rôì	r ô ì
rõ	r õ
rõi	r õ i
rù	r ù
rùa	r ù a
rùi	r ù i
rùm	r ù m
rùn	r ù n
rùng	r ù n g
rú	r ú
rúc	r ú c
rúi	r ú i
rúm	r ú m
rún	r ú n
rúng	r ú n g
rúp	r ú p
rút	r ú t
răm	r ă m
răn	r ă n
răng	r ă n g
rĩ	r ĩ
rĩn	r ĩ n
rũ	r ũ
rũa	r ũ a
rơ	r ơ
rơ-le	r ơ l e
rơ-moóc	r ơ m o ó c
rơ-mông-toa	r ơ m ô n g t o a
rơ-măm	r ơ m ă m
rơ-tua	r ơ t u a
rơi	r ơ i
rơm	r ơ m
rơn	r ơ n
rơn-ghen	r ơ n g h e n
rơn-gơn	r ơ n g ơ n
rư	r ư
rưa	r ư a
rưng	r ư n g
rươi	r ư ơ i
rươm	r ư ơ m
rương	r ư ơ n g
rươu	r ư ơ u
rước	r ư ớ c
rưới	r ư ớ i
rướm	r ư ớ m
rướn	r ư ớ n
rười	r ư ờ i
rườm	r ư ờ m
rườn	r ư ờ n
rường	r ư ờ n g
rưởi	r ư ở i
rưỡi	r ư ỡ i
rượi	r ư ợ i
rượn	r ư ợ n
rượng	r ư ợ n g
rượt	r ư ợ t
rượu	r ư ợ u
rạ	r ạ
rạc	r ạ c
rạch	r ạ c h
rạm	r ạ m
rạn	r ạ n
rạng	r ạ n g
rạo	r ạ o
rạp	r ạ p
rạt	r ạ t
rạy	r ạ y
rả	r ả
rải	r ả i
rảng	r ả n g
rảnh	r ả n h
rảo	r ả o
rảu	r ả u
rảy	r ả y
rấm	r ấ m
rấn	r ấ n
rấp	r ấ p
rất	r ấ t
rầm	r ầ m
rần	r ầ n
rầu	r ầ u
rầy	r ầ y
rẩm	r ẩ m
rẩy	r ẩ y
rẫm	r ẫ m
rẫy	r ẫ y
rậm	r ậ m
rận	r ậ n
rập	r ậ p
rật	r ậ t
rậu	r ậ u
rắc	r ắ c
rắc-co	r ắ c c o
rắm	r ắ m
rắn	r ắ n
rắp	r ắ p
rắt	r ắ t
rằm	r ằ m
rằn	r ằ n
rằng	r ằ n g
rẳn	r ẳ n
rặc	r ặ c
rặm	r ặ m
rặn	r ặ n
rặng	r ặ n g
rặt	r ặ t
rẹo	r ẹ o
rẹt	r ẹ t
rẻ	r ẻ
rẻng	r ẻ n g
rẻo	r ẻ o
rẽ	r ẽ
rế	r ế
rếch	r ế c h
rến	r ế n
rết	r ế t
rếu	r ế u
rề	r ề
rề-gát	r ề g á t
rền	r ề n
rềnh	r ề n h
rều	r ề u
rể	r ể
rểnh	r ể n h
rễ	r ễ
rệ	r ệ
rệch	r ệ c h
rện	r ệ n
rệp	r ệ p
rệt	r ệ t
rệu	r ệ u
rỉ	r ỉ
rỉa	r ỉ a
rỉn	r ỉ n
rỉnh	r ỉ n h
rị	r ị
rịa	r ị a
rịa-vũng	r ị a v ũ n g
rịch	r ị c h
rịn	r ị n
rịp	r ị p
rịt	r ị t
rọ	r ọ
rọc	r ọ c
rọi	r ọ i
rọm	r ọ m
rọn	r ọ n
rọt	r ọ t
rỏ	r ỏ
rỏi	r ỏ i
rỏm	r ỏ m
rỏn	r ỏ n
rỏng	r ỏ n g
rốc	r ố c
rốc-két	r ố c k é t
rốc-kết	r ố c k ế t
rối	r ố i
rốn	r ố n
rống	r ố n g
rốp	r ố p
rốt	r ố t
rồ	r ồ
rồi	r ồ i
rồi!	r ồ i !
rồm	r ồ m
rồn	r ồ n
rồng	r ồ n g
rổ	r ổ
rổi	r ổ i
rổn	r ổ n
rổng	r ổ n g
rỗ	r ỗ
rỗi	r ỗ i
rỗng	r ỗ n g
rộ	r ộ
rộc	r ộ c
rộm	r ộ m
rộn	r ộ n
rộng	r ộ n g
rộp	r ộ p
rột	r ộ t
rớ	r ớ
rớm	r ớ m
rớp	r ớ p
rớt	r ớ t
rớt-xo	r ớ t x o
rờ	r ờ
rờ-com-măng-đê	r ờ c o m m ă n g đ ê
rờ-moọc	r ờ m o ọ c
rờ-séc	r ờ s é c
rờ-sét	r ờ s é t
rờ-sạc	r ờ s ạ c
rờ-tua	r ờ t u a
rờ-tờ-rét	r ờ t ờ r é t
rờ-ve	r ờ v e
rời	r ờ i
rờm	r ờ m
rờn	r ờ n
rở	r ở
rởm	r ở m
rởn	r ở n
rỡ	r ỡ
rỡn	r ỡ n
rợ	r ợ
rợi	r ợ i
rợm	r ợ m
rợn	r ợ n
rợp	r ợ p
rợt	r ợ t
rụ	r ụ
rụa	r ụ a
rục	r ụ c
rụi	r ụ i
rụm	r ụ m
rụng	r ụ n g
rụp	r ụ p
rụt	r ụ t
rủ	r ủ
rủa	r ủ a
rủi	r ủ i
rủn	r ủ n
rủng	r ủ n g
rứa	r ứ a
rức	r ứ c
rứt	r ứ t
rừ	r ừ
rừng	r ừ n g
rửa	r ử a
rửng	r ử n g
rữa	r ữ a
rựa	r ự a
rực	r ự c
rựng	r ự n g
rỵn	r ỵ n
s	s
sa	s a
sa-bô	s a b ô
sa-bô-chê	s a b ô c h ê
sa-ca-rin	s a c a r i n
sa-ca-rô-da	s a c a r ô d a
sa-lát	s a l á t
sa-lông	s a l ô n g
sa-tanh	s a t a n h
sa-ten	s a t e n
sa-van	s a v a n
sachiko	s a c h i k o
sachs	s a c h s
safari	s a f a r i
sai	s a i
saigon	s a i g o n
saijo	s a i j o
saitama	s a i t a m a
sakharov	s a k h a r o v
salad	s a l a d
sale	s a l e
saleh	s a l e h
salem	s a l e m
sales	s a l e s
sally	s a l l y
salon	s a l o n
saloon	s a l o o n
salsa	s a l s a
salt	s a l t
sam	s a m
sam-pô	s a m p ô
samba	s a m b a
samsonite	s a m s o n i t e
samsung	s a m s u n g
san	s a n
san-pết	s a n p ế t
sandra	s a n d r a
sandwich	s a n d w i c h
sang	s a n g
sanh	s a n h
santa	s a n t a
santiago	s a n t i a g o
sao	s a o
sapa	s a p a
saphira	s a p h i r a
saraburi	s a r a b u r i
sarah	s a r a h
sato	s a t o
sau	s a u
saudi	s a u d i
saviola	s a v i o l a
savior	s a v i o r
savoy	s a v o y
say	s a y
scala	s c a l a
scan	s c a n
scandal	s c a n d a l
scandinavian	s c a n d i n a v i a n
scarf	s c a r f
schilling	s c h i l l i n g
school	s c h o o l
schuster	s c h u s t e r
science	s c i e n c e
scooter	s c o o t e r
scotch	s c o t c h
scotland	s c o t l a n d
scott	s c o t t
sctv	s c t v
se	s e
se-ken	s e k e n
search	s e a r c h
seaside	s e a s i d e
seat	s e a t
seatte	s e a t t e
seattle	s e a t t l e
sec	s e c
secure	s e c u r e
security	s e c u r i t y
sedan	s e d a n
seifert	s e i f e r t
selective	s e l e c t i v e
selena	s e l e n a
sen	s e n
send	s e n d
sendai	s e n d a i
seng	s e n g
senko	s e n k o
seo	s e o
seoul	s e o u l
sequoia	s e q u o i a
server	s e r v e r
set	s e t
setting	s e t t i n g
settings	s e t t i n g s
sex	s e x
sexy	s e x y
sh	s h
shape	s h a p e
share	s h a r e
sharon	s h a r o n
sharp	s h a r p
shayla	s h a y l a
shayne	s h a y n e
she	s h e
sheer	s h e e r
shell	s h e l l
shelly	s h e l l y
sheraton	s h e r a t o n
sherlock	s h e r l o c k
shichi	s h i c h i
shihara	s h i h a r a
shima	s h i m a
shimada	s h i m a d a
shinshu	s h i n s h u
ship	s h i p
shop	s h o p
short	s h o r t
show	s h o w
showbiz	s h o w b i z
showtime	s h o w t i m e
shubert	s h u b e r t
si	s i
si-li-cát	s i l i c á t
si-lic	s i l i c
si-linh	s i l i n h
si-líc	s i l í c
si-lích	s i l í c h
si-mi-li	s i m i l i
si-đa	s i đ a
sia	s i a
sic	s i c
sichaleune	s i c h a l e u n e
side	s i d e
signature	s i g n a t u r e
sihamoni	s i h a m o n i
silicon	s i l i c o n
silvia	s i l v i a
sim	s i m
simpson	s i m p s o n
sin	s i n
singapore	s i n g a p o r e
singha	s i n g h a
single	s i n g l e
sinh	s i n h
siphandon	s i p h a n d o n
siphandone	s i p h a n d o n e
sitcom	s i t c o m
siu	s i u
six	s i x
siêm	s i ê m
siêng	s i ê n g
siêu	s i ê u
siếc	s i ế c
siếp	s i ế p
siết	s i ế t
siếu	s i ế u
siểm	s i ể m
siển	s i ể n
siểng	s i ể n g
siễn	s i ễ n
skate	s k a t e
sky	s k y
skype	s k y p e
skyway	s k y w a y
slam	s l a m
sleep	s l e e p
sloan	s l o a n
smart	s m a r t
smartphone	s m a r t p h o n e
smith	s m i t h
smokey	s m o k e y
snapchat	s n a p c h a t
so	s o
soa	s o a
soan	s o a n
soda	s o d a
sofa	s o f a
soft	s o f t
software	s o f t w a r e
soho	s o h o
soi	s o i
sol	s o l
som	s o m
some	s o m e
somphone	s o m p h o n e
son	s o n
son-nê	s o n n ê
song	s o n g
sonne	s o n n e
sonya	s o n y a
soo	s o o
sooke	s o o k e
soong	s o o n g
sophie	s o p h i e
sorry	s o r r y
sosan	s o s a n
soup	s o u p
source	s o u r c e
south	s o u t h
southgate	s o u t h g a t e
soà	s o à
soài	s o à i
soàm	s o à m
soàn	s o à n
soái	s o á i
soán	s o á n
soát	s o á t
soóc	s o ó c
soóc-ti	s o ó c t i
soạn	s o ạ n
soạng	s o ạ n g
soạp	s o ạ p
soạt	s o ạ t
soải	s o ả i
soảng	s o ả n g
soẹt	s o ẹ t
spa	s p a
spacey	s p a c e y
spears	s p e a r s
speed	s p e e d
spice	s p i c e
sporting	s p o r t i n g
sports	s p o r t s
spyware	s p y w a r e
square	s q u a r e
ssi	s s i
stamford	s t a m f o r d
stan	s t a n
stanford	s t a n f o r d
stanton	s t a n t o n
starcraft	s t a r c r a f t
stark	s t a r k
start	s t a r t
starter	s t a r t e r
startup	s t a r t u p
station	s t a t i o n
status	s t a t u s
steak	s t e a k
steering	s t e e r i n g
steve	s t e v e
stevie	s t e v i e
stewart	s t e w a r t
stick	s t i c k
stock	s t o c k
stoke	s t o k e
stone	s t o n e
stonehenge	s t o n e h e n g e
store	s t o r e
story	s t o r y
stream	s t r e a m
street	s t r e e t
stress	s t r e s s
stuart	s t u a r t
studio	s t u d i o
stuttgart	s t u t t g a r t
style	s t y l e
su	s u
su-le	s u l e
su-lơ	s u l ơ
su-su	s u s u
sua	s u a
subang	s u b a n g
subic	s u b i c
sudan	s u d a n
sui	s u i
suk	s u k
sulfa	s u l f a
sum	s u m
sumo	s u m o
sun	s u n
sun-pha-mít	s u n p h a m í t
sun-phu-rích	s u n p h u r í c h
sun-phua	s u n p h u a
sun-phát	s u n p h á t
sundance	s u n d a n c e
sung	s u n g
sunny	s u n n y
sunroof	s u n r o o f
sunset	s u n s e t
supha	s u p h a
support	s u p p o r t
surat	s u r a t
surface	s u r f a c e
susan	s u s a n
sushi	s u s h i
suspect	s u s p e c t
suy	s u y
suyển	s u y ể n
suyễn	s u y ễ n
suzuki	s u z u k i
suân	s u â n
suê	s u ê
suôn	s u ô n
suông	s u ô n g
suý	s u ý
suýt	s u ý t
suất	s u ấ t
suối	s u ố i
suốt	s u ố t
suồng	s u ồ n g
suỵt	s u ỵ t
swift	s w i f t
swing	s w i n g
sydney	s y d n e y
symantec	s y m a n t e c
sync	s y n c
syria	s y r i a
system	s y s t e m
sà	s à
sà-	s à
sà-lan	s à l a n
sà-lúp	s à l ú p
sài	s à i
sài-gòn	s à i g ò n
sàm	s à m
sàn	s à n
sàng	s à n g
sành	s à n h
sào	s à o
sá	s á
sác	s á c
sác-giơ	s á c g i ơ
sách	s á c h
sái	s á i
sám	s á m
sán	s á n
sáng	s á n g
sánh	s á n h
sáo	s á o
sáp	s á p
sát	s á t
sáu	s á u
sâm	s â m
sâm-banh	s â m b a n h
sân	s â n
sâng	s â n g
sâu	s â u
sây	s â y
sã	s ã
sãi	s ã i
sè	s è
sèo	s è o
séc	s é c
sém	s é m
séo	s é o
sét	s é t
sét-ti	s é t t i
sê	s ê
sê-ri	s ê r i
sê-đa	s ê đ a
sên	s ê n
sênh	s ê n h
sêu	s ê u
sì	s ì
sì-cút	s ì c ú t
sìn	s ì n
sình	s ì n h
sí	s í
síc	s í c
sích-ma	s í c h m a
sín	s í n
sính	s í n h
sít	s í t
sò	s ò
sòa	s ò a
sòi	s ò i
sòm	s ò m
sòn	s ò n
sòng	s ò n g
sóc	s ó c
sóc-cảnh	s ó c c ả n h
sói	s ó i
sóm	s ó m
són	s ó n
sóng	s ó n g
sóoc	s ó o c
sót	s ó t
sô	s ô
sô-	s ô
sô-cô-la	s ô c ô l a
sô-de	s ô d e
sô-lít	s ô l í t
sô-lô	s ô l ô
sô-nát	s ô n á t
sô-pha	s ô p h a
sô-vanh	s ô v a n h
sô-đa	s ô đ a
sôi	s ô i
sôn	s ô n
sông	s ô n g
sõi	s õ i
sõng	s õ n g
sù	s ù
sùi	s ù i
sùm	s ù m
sùng	s ù n g
sú	s ú
sú-ba-giăng	s ú b a g i ă n g
súc	s ú c
súc-cù-la	s ú c c ù l a
sún	s ú n
súng	s ú n g
súp	s ú p
súp-de	s ú p d e
súp-lơ	s ú p l ơ
sút	s ú t
súy	s ú y
sý	s ý
săm	s ă m
săm-banh	s ă m b a n h
săm-pa-nhơ	s ă m p a n h ơ
săm-pan	s ă m p a n
săn	s ă n
săng	s ă n g
săng-chi-ê	s ă n g c h i ê
săng-ta	s ă n g t a
săng-tan	s ă n g t a n
săng-đay	s ă n g đ a y
sĩ	s ĩ
sũng	s ũ n g
sơ	s ơ
sơ-mi	s ơ m i
sơ-mi-dét	s ơ m i d é t
sơ-va-lê	s ơ v a l ê
sơ-vi-ốt	s ơ v i ố t
sơ-vơ	s ơ v ơ
sơi	s ơ i
sơm	s ơ m
sơn	s ơ n
sư	s ư
sưa	s ư a
sưng	s ư n g
sưu	s ư u
sươi	s ư ơ i
sương	s ư ơ n g
sước	s ư ớ c
sướng	s ư ớ n g
sướt	s ư ớ t
sườn	s ư ờ n
sường	s ư ờ n g
sưởi	s ư ở i
sưởng	s ư ở n g
sượng	s ư ợ n g
sượt	s ư ợ t
sạ	s ạ
sạc	s ạ c
sạch	s ạ c h
sại	s ạ i
sạm	s ạ m
sạn	s ạ n
sạo	s ạ o
sạp	s ạ p
sạt	s ạ t
sả	s ả
sải	s ả i
sảm	s ả m
sản	s ả n
sảng	s ả n g
sảnh	s ả n h
sảo	s ả o
sảy	s ả y
sấm	s ấ m
sấn	s ấ n
sấp	s ấ p
sất	s ấ t
sấu	s ấ u
sấy	s ấ y
sầm	s ầ m
sần	s ầ n
sầu	s ầ u
sầy	s ầ y
sẩm	s ẩ m
sẩn	s ẩ n
sẩy	s ẩ y
sẫm	s ẫ m
sậm	s ậ m
sập	s ậ p
sật	s ậ t
sậu	s ậ u
sậy	s ậ y
sắc	s ắ c
sắc-xô	s ắ c x ô
sắc-xô-phôn	s ắ c x ô p h ô n
sắm	s ắ m
sắn	s ắ n
sắng	s ắ n g
sắp	s ắ p
sắt	s ắ t
sằng	s ằ n g
sẳn	s ẳ n
sẵn	s ẵ n
sẵng	s ẵ n g
sẵp	s ẵ p
sặc	s ặ c
sặm	s ặ m
sặt	s ặ t
sẹ	s ẹ
sẹm	s ẹ m
sẹo	s ẹ o
sẹp	s ẹ p
sẹt	s ẹ t
sẻ	s ẻ
sẻn	s ẻ n
sẽ	s ẽ
sế	s ế
sến	s ế n
sếp	s ế p
sếu	s ế u
sề	s ề
sền	s ề n
sềnh	s ề n h
sều	s ề u
sể	s ể
sểnh	s ể n h
sễ	s ễ
sệ	s ệ
sệch	s ệ c h
sệp	s ệ p
sệt	s ệ t
sỉ	s ỉ
sỉa	s ỉ a
sỉnh	s ỉ n h
sị	s ị
sịa	s ị a
sịch	s ị c h
sịt	s ị t
sọ	s ọ
sọa	s ọ a
sọc	s ọ c
sọm	s ọ m
sọt	s ọ t
sỏ	s ỏ
sỏa	s ỏ a
sỏi	s ỏ i
số	s ố
sốc	s ố c
sống	s ố n g
sốp	s ố p
sốp-phơ	s ố p p h ơ
sốt	s ố t
sồ	s ồ
sồi	s ồ i
sồn	s ồ n
sồng	s ồ n g
sổ	s ổ
sổi	s ổ i
sổng	s ổ n g
sỗ	s ỗ
sộ	s ộ
sộc	s ộ c
sộp	s ộ p
sột	s ộ t
sớ	s ớ
sới	s ớ i
sớm	s ớ m
sớn	s ớ n
sớt	s ớ t
sờ	s ờ
sờm	s ờ m
sờn	s ờ n
sở	s ở
sởi	s ở i
sởn	s ở n
sỡ	s ỡ
sợ	s ợ
sợi	s ợ i
sụ	s ụ
sụa	s ụ a
sục	s ụ c
sụm	s ụ m
sụn	s ụ n
sụp	s ụ p
sụt	s ụ t
sủ	s ủ
sủa	s ủ a
sủi	s ủ i
sủng	s ủ n g
sủy	s ủ y
sứ	s ứ
sứa	s ứ a
sức	s ứ c
sứt	s ứ t
sứu	s ứ u
sừ	s ừ
sừn	s ừ n
sừng	s ừ n g
sử	s ử
sửa	s ử a
sửng	s ử n g
sửu	s ử u
sữa	s ữ a
sững	s ữ n g
sự	s ự
sực	s ự c
sựng	s ự n g
sựt	s ự t
sỹ	s ỹ
t	t
ta	t a
ta-bu	t a b u
ta-ca	t a c a
ta-luy	t a l u y
ta-lông	t a l ô n g
ta-lư	t a l ư
ta-nanh	t a n a n h
ta-nin	t a n i n
ta-pi	t a p i
ta-rô	t a r ô
ta-tu	t a t u
ta-tăng	t a t ă n g
tab	t a b
tabasco	t a b a s c o
tablet	t a b l e t
tae	t a e
taekwondo	t a e k w o n d o
tahoe	t a h o e
tai	t a i
tai-ga	t a i g a
takagi	t a k a g i
takahashi	t a k a h a s h i
takako	t a k a k o
takashi	t a k a s h i
tam	t a m
taman	t a m a n
tan	t a n
tanaka	t a n a k a
tang	t a n g
tanh	t a n h
tanh-ban	t a n h b a n
tanizaki	t a n i z a k i
tanner	t a n n e r
tao	t a o
tapio	t a p i o
tario	t a r i o
taro	t a r o
task	t a s k
tasman	t a s m a n
tat	t a t
tau	t a u
tauron	t a u r o n
taxi	t a x i
tay	t a y
tay-ơ	t a y ơ
taylor	t a y l o r
taù	t a ù
te	t e
team	t e a m
techcombank	t e c h c o m b a n k
ted	t e d
teen	t e e n
teens	t e e n s
tele	t e l e
telemere	t e l e m e r e
telephone	t e l e p h o n e
tell	t e l l
tem	t e m
tempura	t e m p u r a
ten	t e n
ten-nít	t e n n í t
tenerife	t e n e r i f e
teng	t e n g
tennessee	t e n n e s s e e
tennis	t e n n i s
teo	t e o
test	t e s t
texas	t e x a s
tha	t h a
thai	t h a i
thailand	t h a i l a n d
tham	t h a m
than	t h a n
thang	t h a n g
thanh	t h a n h
thank	t h a n k
thanks	t h a n k s
thao	t h a o
thatcher	t h a t c h e r
thau	t h a u
thay	t h a y
the	t h e
them	t h e m
theme	t h e m e
then	t h e n
theo	t h e o
theron	t h e r o n
thi	t h i
thia	t h i a
thick	t h i c k
thiel	t h i e l
thin	t h i n
thinh	t h i n h
thiu	t h i u
thiêm	t h i ê m
thiên	t h i ê n
thiên-huế	t h i ê n h u ế
thiêng	t h i ê n g
thiêu	t h i ê u
thiếc	t h i ế c
thiến	t h i ế n
thiếp	t h i ế p
thiết	t h i ế t
thiếu	t h i ế u
thiềm	t h i ề m
thiền	t h i ề n
thiềng	t h i ề n g
thiều	t h i ề u
thiểm	t h i ể m
thiển	t h i ể n
thiểu	t h i ể u
thiễm	t h i ễ m
thiệm	t h i ệ m
thiện	t h i ệ n
thiệp	t h i ệ p
thiệt	t h i ệ t
thiệu	t h i ệ u
tho	t h o
thoa	t h o a
thoai	t h o a i
thoan	t h o a n
thoang	t h o a n g
thoi	t h o i
thom	t h o m
thomas	t h o m a s
thon	t h o n
thong	t h o n g
thor	t h o r
thorton	t h o r t o n
thoà	t h o à
thoàn	t h o à n
thoá	t h o á
thoái	t h o á i
thoán	t h o á n
thoáng	t h o á n g
thoát	t h o á t
thoã	t h o ã
thoòng	t h o ò n g
thoăn	t h o ă n
thoại	t h o ạ i
thoạt	t h o ạ t
thoả	t h o ả
thoải	t h o ả i
thoản	t h o ả n
thoảng	t h o ả n g
thoắng	t h o ắ n g
thoắt	t h o ắ t
thu	t h u
thu-lao	t h u l a o
thua	t h u a
thui	t h u i
thum	t h u m
thumbnail	t h u m b n a i l
thun	t h u n
thung	t h u n g
thursday	t h u r s d a y
thuyên	t h u y ê n
thuyết	t h u y ế t
thuyền	t h u y ề n
thuân	t h u â n
thuê	t h u ê
thuôn	t h u ô n
thuông	t h u ô n g
thuý	t h u ý
thuơng	t h u ơ n g
thuạt	t h u ạ t
thuấn	t h u ấ n
thuần	t h u ầ n
thuẫn	t h u ẫ n
thuận	t h u ậ n
thuật	t h u ậ t
thuế	t h u ế
thuể	t h u ể
thuốc	t h u ố c
thuốn	t h u ố n
thuồi	t h u ồ i
thuồn	t h u ồ n
thuồng	t h u ồ n g
thuổc	t h u ổ c
thuổng	t h u ổ n g
thuỗn	t h u ỗ n
thuộc	t h u ộ c
thuội	t h u ộ i
thuộm	t h u ộ m
thuột	t h u ộ t
thuở	t h u ở
thuỳ	t h u ỳ
thuỵ	t h u ỵ
thuỷ	t h u ỷ
thyền	t h y ề n
thà	t h à
thài	t h à i
thàm	t h à m
thàng	t h à n g
thành	t h à n h
thào	t h à o
thày	t h à y
thá	t h á
thác	t h á c
thách	t h á c h
thái	t h á i
thám	t h á m
thán	t h á n
tháng	t h á n g
thánh	t h á n h
tháo	t h á o
tháp	t h á p
thát	t h á t
tháu	t h á u
tháy	t h á y
thâm	t h â m
thân	t h â n
thâu	t h â u
thây	t h â y
thãi	t h ã i
thãng	t h ã n g
thè	t h è
thèm	t h è m
thèn	t h è n
thèo	t h è o
thé	t h é
thép	t h é p
thét	t h é t
thê	t h ê
thê-ta	t h ê t a
thêm	t h ê m
thênh	t h ê n h
thêu	t h ê u
thì	t h ì
thìa	t h ì a
thìn	t h ì n
thình	t h ì n h
thìu	t h ì u
thí	t h í
thía	t h í a
thích	t h í c h
thím	t h í m
thín	t h í n
thính	t h í n h
thíp	t h í p
thít	t h í t
thò	t h ò
thòa	t h ò a
thòi	t h ò i
thòm	t h ò m
thòng	t h ò n g
thó	t h ó
thóa	t h ó a
thóc	t h ó c
thói	t h ó i
thóm	t h ó m
thón	t h ó n
thóp	t h ó p
thót	t h ó t
thô	t h ô
thôi	t h ô i
thôn	t h ô n
thông	t h ô n g
thõa	t h õ a
thõm	t h õ m
thõng	t h õ n g
thù	t h ù
thùa	t h ù a
thùi	t h ù i
thùm	t h ù m
thùn	t h ù n
thùng	t h ù n g
thùy	t h ù y
thú	t h ú
thúc	t h ú c
thúi	t h ú i
thúng	t h ú n g
thút	t h ú t
thúy	t h ú y
thăm	t h ă m
thăn	t h ă n
thăng	t h ă n g
thĩ	t h ĩ
thũng	t h ũ n g
thơ	t h ơ
thơi	t h ơ i
thơm	t h ơ m
thơn	t h ơ n
thư	t h ư
thưa	t h ư a
thưc	t h ư c
thưeo	t h ư e o
thưng	t h ư n g
thương	t h ư ơ n g
thước	t h ư ớ c
thướng	t h ư ớ n g
thướt	t h ư ớ t
thười	t h ư ờ i
thườn	t h ư ờ n
thường	t h ư ờ n g
thưởng	t h ư ở n g
thưỡi	t h ư ỡ i
thưỡn	t h ư ỡ n
thược	t h ư ợ c
thượng	t h ư ợ n g
thượt	t h ư ợ t
thạc	t h ạ c
thạch	t h ạ c h
thạnh	t h ạ n h
thạo	t h ạ o
thạp	t h ạ p
thả	t h ả
thải	t h ả i
thảm	t h ả m
thản	t h ả n
thảng	t h ả n g
thảnh	t h ả n h
thảo	t h ả o
thảy	t h ả y
thấm	t h ấ m
thấn	t h ấ n
thấp	t h ấ p
thất	t h ấ t
thấu	t h ấ u
thấy	t h ấ y
thầm	t h ầ m
thần	t h ầ n
thầu	t h ầ u
thầy	t h ầ y
thẩm	t h ẩ m
thẩn	t h ẩ n
thẩu	t h ẩ u
thẩy	t h ẩ y
thẫm	t h ẫ m
thẫn	t h ẫ n
thậm	t h ậ m
thận	t h ậ n
thập	t h ậ p
thật	t h ậ t
thắc	t h ắ c
thắm	t h ắ m
thắn	t h ắ n
thắng	t h ắ n g
thắp	t h ắ p
thắt	t h ắ t
thằn	t h ằ n
thằng	t h ằ n g
thẳm	t h ẳ m
thẳng	t h ẳ n g
thặng	t h ặ n g
thẹn	t h ẹ n
thẹo	t h ẹ o
thẹp	t h ẹ p
thẻ	t h ẻ
thẻn	t h ẻ n
thẻo	t h ẻ o
thẽ	t h ẽ
thế	t h ế
thếch	t h ế c h
thếp	t h ế p
thết	t h ế t
thề	t h ề
thềm	t h ề m
thều	t h ề u
thể	t h ể
thểu	t h ể u
thệ	t h ệ
thệch	t h ệ c h
thện	t h ệ n
thỉ	t h ỉ
thỉnh	t h ỉ n h
thỉu	t h ỉ u
thị	t h ị
thịch	t h ị c h
thịnh	t h ị n h
thịt	t h ị t
thịu	t h ị u
thọ	t h ọ
thọc	t h ọ c
thọt	t h ọ t
thỏ	t h ỏ
thỏa	t h ỏ a
thỏi	t h ỏ i
thỏm	t h ỏ m
thố	t h ố
thốc	t h ố c
thối	t h ố i
thốn	t h ố n
thống	t h ố n g
thốt	t h ố t
thồ	t h ồ
thồi	t h ồ i
thồm	t h ồ m
thồn	t h ồ n
thổ	t h ổ
thổi	t h ổ i
thổn	t h ổ n
thỗn	t h ỗ n
thộc	t h ộ c
thộn	t h ộ n
thộp	t h ộ p
thột	t h ộ t
thớ	t h ớ
thới	t h ớ i
thớm	t h ớ m
thớt	t h ớ t
thờ	t h ờ
thời	t h ờ i
thờm	t h ờ m
thờn	t h ờ n
thở	t h ở
thợ	t h ợ
thợt	t h ợ t
thụ	t h ụ
thục	t h ụ c
thụi	t h ụ i
thụng	t h ụ n g
thụp	t h ụ p
thụt	t h ụ t
thụy	t h ụ y
thủ	t h ủ
thủa	t h ủ a
thủi	t h ủ i
thủm	t h ủ m
thủng	t h ủ n g
thủy	t h ủ y
thứ	t h ứ
thức	t h ứ c
thứng	t h ứ n g
thứu	t h ứ u
thừ	t h ừ
thừa	t h ừ a
thừng	t h ừ n g
thử	t h ử
thửa	t h ử a
thửng	t h ử n g
thữ	t h ữ
thững	t h ữ n g
thự	t h ự
thực	t h ự c
ti	t i
ti-cô	t i c ô
ti-dôn	t i d ô n
ti-gôn	t i g ô n
ti-len	t i l e n
ti-pô	t i p ô
ti-ra	t i r a
ti-tan	t i t a n
ti-vi	t i v i
tia	t i a
tia-bu-sông	t i a b u s ô n g
tia-ra	t i a r a
tie	t i e
tiebreak	t i e b r e a k
tiger	t i g e r
tiiền	t i i ề n
tim	t i m
time	t i m e
times	t i m e s
tin	t i n
tina	t i n a
ting	t i n g
tinh	t i n h
titanic	t i t a n i c
tiu	t i u
tivi	t i v i
tiêm	t i ê m
tiên	t i ê n
tiêng	t i ê n g
tiêu	t i ê u
tiếc	t i ế c
tiếm	t i ế m
tiến	t i ế n
tiếng	t i ế n g
tiếp	t i ế p
tiết	t i ế t
tiếu	t i ế u
tiềm	t i ề m
tiền	t i ề n
tiềng	t i ề n g
tiều	t i ề u
tiển	t i ể n
tiểng	t i ể n g
tiểu	t i ể u
tiễn	t i ễ n
tiễu	t i ễ u
tiệc	t i ệ c
tiệm	t i ệ m
tiện	t i ệ n
tiệp	t i ệ p
tiệt	t i ệ t
to	t o
to-nô	t o n ô
toa	t o a
toa-lét	t o a l é t
toan	t o a n
toang	t o a n g
toanh	t o a n h
today	t o d a y
toe	t o e
toen	t o e n
together	t o g e t h e r
toi	t o i
toilet	t o i l e t
tokyo	t o k y o
tokyô	t o k y ô
tom	t o m
tomoko	t o m o k o
ton	t o n
ton-nô	t o n n ô
tone	t o n e
tong	t o n g
tony	t o n y
tool	t o o l
toolbar	t o o l b a r
tools	t o o l s
toong	t o o n g
top	t o p
topaz	t o p a z
topic	t o p i c
torres	t o r r e s
tottenham	t o t t e n h a m
touch	t o u c h
toulouse	t o u l o u s e
tour	t o u r
tower	t o w e r
town	t o w n
toy	t o y
toyota	t o y o t a
toà	t o à
toài	t o à i
toàn	t o à n
toàng	t o à n g
toá	t o á
toác	t o á c
toái	t o á i
toán	t o á n
toáng	t o á n g
toánh	t o á n h
toát	t o á t
toáy	t o á y
toè	t o è
toèn	t o è n
toé	t o é
toét	t o é t
toòng	t o ò n g
toóc	t o ó c
toóc-si	t o ó c s i
toạ	t o ạ
toạc	t o ạ c
toại	t o ạ i
toạng	t o ạ n g
toả	t o ả
toản	t o ả n
toẹt	t o ẹ t
toẻ	t o ẻ
toẽ	t o ẽ
tra	t r a
tra-côm	t r a c ô m
trade	t r a d e
trafford	t r a f f o r d
trai	t r a i
tram	t r a m
tran	t r a n
tran-di-to	t r a n d i t o
trang	t r a n g
tranh	t r a n h
trao	t r a o
trau	t r a u
trax	t r a x
tre	t r e
tren	t r e n
treng	t r e n g
treo	t r e o
tri	t r i
tri-ốt	t r i ố t
trichet	t r i c h e t
trick	t r i c k
tring	t r i n g
trinh	t r i n h
trinity	t r i n i t y
triton	t r i t o n
triêm	t r i ê m
triêng	t r i ê n g
triêu	t r i ê u
triến	t r i ế n
triếp	t r i ế p
triết	t r i ế t
triền	t r i ề n
triềng	t r i ề n g
triều	t r i ề u
triển	t r i ể n
triện	t r i ệ n
triệng	t r i ệ n g
triệp	t r i ệ p
triệt	t r i ệ t
triệu	t r i ệ u
tro	t r o
troi	t r o i
trom	t r o m
trom-pét	t r o m p é t
tron	t r o n
trong	t r o n g
troẹt	t r o ẹ t
tru	t r u
trui	t r u i
trun	t r u n
trung	t r u n g
truong	t r u o n g
truy	t r u y
truyến	t r u y ế n
truyền	t r u y ề n
truyện	t r u y ệ n
truân	t r u â n
truông	t r u ô n g
truất	t r u ấ t
truật	t r u ậ t
truồi	t r u ồ i
truồng	t r u ồ n g
truột	t r u ộ t
truờng	t r u ờ n g
truỵ	t r u ỵ
trà	t r à
trài	t r à i
tràm	t r à m
tràn	t r à n
tràng	t r à n g
trành	t r à n h
trào	t r à o
tràu	t r à u
trày	t r à y
trá	t r á
trác	t r á c
trách	t r á c h
trái	t r á i
trám	t r á m
trán	t r á n
tráng	t r á n g
tránh	t r á n h
tráo	t r á o
tráp	t r á p
trát	t r á t
trâm	t r â m
trân	t r â n
trâng	t r â n g
trâu	t r â u
trây	t r â y
trã	t r ã
trãi	t r ã i
trè	t r è
trèm	t r è m
trèn	t r è n
trèo	t r è o
tréc	t r é c
trém	t r é m
tréo	t r é o
trét	t r é t
trê	t r ê
trên	t r ê n
trêu	t r ê u
trì	t r ì
trình	t r ì n h
trìu	t r ì u
trí	t r í
tría	t r í a
trích	t r í c h
trính	t r í n h
trít	t r í t
tríu	t r í u
trò	t r ò
tròi	t r ò i
tròm	t r ò m
tròn	t r ò n
tròng	t r ò n g
tróc	t r ó c
trói	t r ó i
tróm	t r ó m
tróng	t r ó n g
trót	t r ó t
trô	t r ô
trô-lây-buýt	t r ô l â y b u ý t
trô-pi-can	t r ô p i c a n
trôi	t r ô i
trôm	t r ô m
trôm-bôn	t r ô m b ô n
trôm-pét	t r ô m p é t
trôn	t r ô n
trông	t r ô n g
trõm	t r õ m
trõn	t r õ n
trù	t r ù
trùi	t r ù i
trùm	t r ù m
trùn	t r ù n
trùng	t r ù n g
trùy	t r ù y
trú	t r ú
trúc	t r ú c
trúm	t r ú m
trúng	t r ú n g
trút	t r ú t
trúy	t r ú y
trăm	t r ă m
trăn	t r ă n
trăng	t r ă n g
trăng-dít	t r ă n g d í t
trĩ	t r ĩ
trĩnh	t r ĩ n h
trĩu	t r ĩ u
trũi	t r ũ i
trũng	t r ũ n g
trơ	t r ơ
trơi	t r ơ i
trơn	t r ơ n
trư	t r ư
trưa	t r ư a
trưng	t r ư n g
trương	t r ư ơ n g
trước	t r ư ớ c
trướng	t r ư ớ n g
trườn	t r ư ờ n
trường	t r ư ờ n g
trưởng	t r ư ở n g
trưỡng	t r ư ỡ n g
trượng	t r ư ợ n g
trượt	t r ư ợ t
trạc	t r ạ c
trạch	t r ạ c h
trại	t r ạ i
trạm	t r ạ m
trạn	t r ạ n
trạng	t r ạ n g
trạnh	t r ạ n h
trạo	t r ạ o
trạt	t r ạ t
trạy	t r ạ y
trả	t r ả
trải	t r ả i
trảm	t r ả m
trản	t r ả n
trảng	t r ả n g
trảnh	t r ả n h
trảo	t r ả o
trảu	t r ả u
trảy	t r ả y
trấm	t r ấ m
trấn	t r ấ n
trấp	t r ấ p
trất	t r ấ t
trấu	t r ấ u
trầm	t r ầ m
trần	t r ầ n
trầu	t r ầ u
trầy	t r ầ y
trẩm	t r ẩ m
trẩn	t r ẩ n
trẩu	t r ẩ u
trẩy	t r ẩ y
trẫm	t r ẫ m
trậm	t r ậ m
trận	t r ậ n
trập	t r ậ p
trật	t r ậ t
trắc	t r ắ c
trắm	t r ắ m
trắng	t r ắ n g
trắt	t r ắ t
trằm	t r ằ m
trằn	t r ằ n
trằng	t r ằ n g
trẳng	t r ẳ n g
trặc	t r ặ c
trặn	t r ặ n
trẹ	t r ẹ
trẹo	t r ẹ o
trẹt	t r ẹ t
trẻ	t r ẻ
trẻo	t r ẻ o
trẽ	t r ẽ
trẽn	t r ẽ n
trẽo	t r ẽ o
trếch	t r ế c h
trếnh	t r ế n h
trết	t r ế t
trếu	t r ế u
trề	t r ề
trển	t r ể n
trễ	t r ễ
trệ	t r ệ
trệch	t r ệ c h
trệt	t r ệ t
trệu	t r ệ u
trỉa	t r ỉ a
trị	t r ị
trịa	t r ị a
trịch	t r ị c h
trịnh	t r ị n h
trịt	t r ị t
trọ	t r ọ
trọc	t r ọ c
trọi	t r ọ i
trọn	t r ọ n
trọng	t r ọ n g
trọt	t r ọ t
trỏ	t r ỏ
trỏi	t r ỏ i
trỏng	t r ỏ n g
trố	t r ố
trốc	t r ố c
trối	t r ố i
trốn	t r ố n
trống	t r ố n g
trốt	t r ố t
trồ	t r ồ
trồi	t r ồ i
trồng	t r ồ n g
trổ	t r ổ
trổi	t r ổ i
trổng	t r ổ n g
trỗ	t r ỗ
trỗi	t r ỗ i
trộ	t r ộ
trộc	t r ộ c
trội	t r ộ i
trộm	t r ộ m
trộn	t r ộ n
trộng	t r ộ n g
trớ	t r ớ
trới	t r ớ i
trớn	t r ớ n
trớp	t r ớ p
trớt	t r ớ t
trờ	t r ờ
trời	t r ờ i
trờm	t r ờ m
trờn	t r ờ n
trở	t r ở
trợ	t r ợ
trợn	t r ợ n
trợt	t r ợ t
trụ	t r ụ
trụa	t r ụ a
trục	t r ụ c
trụi	t r ụ i
trụm	t r ụ m
trụn	t r ụ n
trụng	t r ụ n g
trụp	t r ụ p
trụt	t r ụ t
trụy	t r ụ y
trủ	t r ủ
trủng	t r ủ n g
trứ	t r ứ
trứng	t r ứ n g
trứu	t r ứ u
trừ	t r ừ
trừa	t r ừ a
trừng	t r ừ n g
trừu	t r ừ u
trử	t r ử
trửng	t r ử n g
trửu	t r ử u
trữ	t r ữ
trững	t r ữ n g
trữu	t r ữ u
trự	t r ự
trực	t r ự c
ts	t s
tu	t u
tu-bin	t u b i n
tu-lơ-khơ	t u l ơ k h ơ
tu-vang	t u v a n g
tua	t u a
tua-bin	t u a b i n
tua-ma-lin	t u a m a l i n
tua-vít	t u a v í t
tui	t u i
tum	t u m
tun	t u n
tung	t u n g
tunisia	t u n i s i a
tus	t u s
tusumbadan	t u s u m b a d a n
tuy	t u y
tuy-líp	t u y l í p
tuy-ô	t u y ô
tuya	t u y a
tuyn	t u y n
tuynh	t u y n h
tuyên	t u y ê n
tuyếc-bin	t u y ế c b i n
tuyến	t u y ế n
tuyết	t u y ế t
tuyền	t u y ề n
tuyển	t u y ể n
tuyệt	t u y ệ t
tuân	t u â n
tuí	t u í
tuôn	t u ô n
tuông	t u ô n g
tuý	t u ý
tuýp	t u ý p
tuýt	t u ý t
tuýt-xo	t u ý t x o
tuấn	t u ấ n
tuất	t u ấ t
tuần	t u ầ n
tuẩn	t u ẩ n
tuẫn	t u ẫ n
tuế	t u ế
tuếch	t u ế c h
tuềnh	t u ề n h
tuệ	t u ệ
tuệch	t u ệ c h
tuốc	t u ố c
tuốc-bin	t u ố c b i n
tuốc-năng	t u ố c n ă n g
tuốc-nơ-vít	t u ố c n ơ v í t
tuốn	t u ố n
tuốt	t u ố t
tuồi	t u ồ i
tuồn	t u ồ n
tuồng	t u ồ n g
tuổi	t u ổ i
tuộc	t u ộ c
tuột	t u ộ t
tuớng	t u ớ n g
tuỳ	t u ỳ
tuỵ	t u ỵ
tuỷ	t u ỷ
tv	t v
tvtv	t v t v
tweet	t w e e t
twitter	t w i t t e r
ty	t y
tà	t à
tà-ôi	t à ô i
tài	t à i
tàm	t à m
tàn	t à n
tàng	t à n g
tành	t à n h
tào	t à o
tàu	t à u
tày	t à y
tày-nùng	t à y n ù n g
tày-thái	t à y t h á i
tá	t á
tác	t á c
tác-tuýp	t á c t u ý p
tách	t á c h
tái	t á i
tám	t á m
tán	t á n
táng	t á n g
tánh	t á n h
táo	t á o
táp	t á p
táp-lô	t á p l ô
tát	t á t
táu	t á u
táy	t á y
tâm	t â m
tân	t â n
tâng	t â n g
tâu	t â u
tây	t â y
tây-nam	t â y n a m
tã	t ã
tãi	t ã i
tè	t è
tèm	t è m
tèn	t è n
tèng	t è n g
tèo	t è o
té	t é
téc	t é c
téc-gan	t é c g a n
téc-mốt	t é c m ố t
tém	t é m
tén	t é n
téo	t é o
tép	t é p
tét	t é t
tê	t ê
tê-lê	t ê l ê
tê-lê-gam	t ê l ê g a m
tê-lê-phon	t ê l ê p h o n
tê-lê-phôn	t ê l ê p h ô n
tê-lê-típ	t ê l ê t í p
tê-lếc	t ê l ế c
tê-lếch	t ê l ế c h
tê-ta-nốt	t ê t a n ố t
tê-ta-xi-lin	t ê t a x i l i n
tê-tơ-ra-xi-lin	t ê t ơ r a x i l i n
têm	t ê m
tên	t ê n
tênh	t ê n h
têt	t ê t
têu	t ê u
tì	t ì
tìm	t ì m
tình	t ì n h
tí	t í
tí-te	t í t e
tía	t í a
tích	t í c h
tích-kê	t í c h k ê
tích-tắc	t í c h t ắ c
tím	t í m
tín	t í n
tính	t í n h
típ	t í p
tít	t í t
tít-xuy	t í t x u y
tíu	t í u
tò	t ò
tò-he	t ò h e
tòa	t ò a
tòe	t ò e
tòi	t ò i
tòm	t ò m
tòn	t ò n
tòng	t ò n g
tó	t ó
tóa	t ó a
tóc	t ó c
tóe	t ó e
tói	t ó i
tóm	t ó m
tóp	t ó p
tót	t ó t
tô	t ô
tô-buýt	t ô b u ý t
tô-giơ	t ô g i ơ
tô-mát	t ô m á t
tô-nô	t ô n ô
tô-pô	t ô p ô
tô-pô-học	t ô p ô h ọ c
tô-tan	t ô t a n
tô-tem	t ô t e m
tôi	t ô i
tôm	t ô m
tôm-bô-la	t ô m b ô l a
tôn	t ô n
tông	t ô n g
tông-đơ	t ô n g đ ơ
tõm	t õ m
tù	t ù
tùa	t ù a
tùm	t ù m
tùng	t ù n g
tùng-bê	t ù n g b ê
tùy	t ù y
tú	t ú
tú-xơn	t ú x ơ n
túa	t ú a
túc	t ú c
túi	t ú i
túm	t ú m
túng	t ú n g
túp	t ú p
tút	t ú t
tút-xuỵt	t ú t x u ỵ t
túy	t ú y
tý	t ý
tăm	t ă m
tăm-bông	t ă m b ô n g
tăm-pông	t ă m p ô n g
tăn	t ă n
tăng	t ă n g
tăng-bo	t ă n g b o
tăng-gô	t ă n g g ô
tăng-mo	t ă n g m o
tăng-phô	t ă n g p h ô
tăng-phú	t ă n g p h ú
tăng-sê	t ă n g s ê
tăng-sông	t ă n g s ô n g
tăng-xin	t ă n g x i n
tăng-xê	t ă n g x ê
tăng-xông	t ă n g x ô n g
tăng-xương	t ă n g x ư ơ n g
tăng-đơ	t ă n g đ ơ
tĩ	t ĩ
tĩn	t ĩ n
tĩnh	t ĩ n h
tĩu	t ĩ u
tũm	t ũ m
tũn	t ũ n
tơ	t ơ
tơ-hung	t ơ h u n g
tơ-lô	t ơ l ô
tơ-năng	t ơ n ă n g
tơ-ring	t ơ r i n g
tơ-riêng	t ơ r i ê n g
tơ-rưng	t ơ r ư n g
tơ-rớt	t ơ r ớ t
tơi	t ơ i
tơn	t ơ n
tư	t ư
tưa	t ư a
tưng	t ư n g
tưu	t ư u
tươi	t ư ơ i
tươm	t ư ơ m
tương	t ư ơ n g
tước	t ư ớ c
tưới	t ư ớ i
tướn	t ư ớ n
tướng	t ư ớ n g
tướp	t ư ớ p
tướt	t ư ớ t
tườm	t ư ờ m
tường	t ư ờ n g
tườu	t ư ờ u
tưởi	t ư ở i
tưởng	t ư ở n g
tược	t ư ợ c
tượng	t ư ợ n g
tượp	t ư ợ p
tượt	t ư ợ t
tạ	t ạ
tạc	t ạ c
tạch	t ạ c h
tại	t ạ i
tạm	t ạ m
tạng	t ạ n g
tạng-miến	t ạ n g m i ế n
tạnh	t ạ n h
tạo	t ạ o
tạp	t ạ p
tạp-dề	t ạ p d ề
tạt	t ạ t
tả	t ả
tải	t ả i
tảm	t ả m
tản	t ả n
tảng	t ả n g
tảo	t ả o
tấc	t ấ c
tấm	t ấ m
tấn	t ấ n
tấp	t ấ p
tất	t ấ t
tấu	t ấ u
tấy	t ấ y
tầm	t ầ m
tần	t ầ n
tầng	t ầ n g
tầu	t ầ u
tầy	t ầ y
tẩm	t ẩ m
tẩn	t ẩ n
tẩu	t ẩ u
tẩy	t ẩ y
tẫn	t ẫ n
tẫu	t ẫ u
tậm	t ậ m
tận	t ậ n
tập	t ậ p
tật	t ậ t
tậu	t ậ u
tắc	t ắ c
tắc-te	t ắ c t e
tắc-tích	t ắ c t í c h
tắc-xi	t ắ c x i
tắc-xê	t ắ c x ê
tắm	t ắ m
tắn	t ắ n
tắng	t ắ n g
tắp	t ắ p
tắt	t ắ t
tằm	t ằ m
tằn	t ằ n
tằng	t ằ n g
tẳn	t ẳ n
tặc	t ặ c
tặn	t ặ n
tặng	t ặ n g
tẹc	t ẹ c
tẹo	t ẹ o
tẹp	t ẹ p
tẹt	t ẹ t
tẻ	t ẻ
tẻm	t ẻ m
tẻo	t ẻ o
tẽ	t ẽ
tẽn	t ẽ n
tế	t ế
tếch	t ế c h
tết	t ế t
tếu	t ế u
tề	t ề
tềnh	t ề n h
tể	t ể
tểnh	t ể n h
tễ	t ễ
tễnh	t ễ n h
tệ	t ệ
tệp	t ệ p
tỉ	t ỉ
tỉa	t ỉ a
tỉm	t ỉ m
tỉnh	t ỉ n h
tỉu	t ỉ u
tị	t ị
tịa	t ị a
tịch	t ị c h
tịnh	t ị n h
tịt	t ị t
tịu	t ị u
tọ	t ọ
tọa	t ọ a
tọc	t ọ c
tọng	t ọ n g
tọp	t ọ p
tọt	t ọ t
tỏ	t ỏ
tỏa	t ỏ a
tỏe	t ỏ e
tỏi	t ỏ i
tỏm	t ỏ m
tỏng	t ỏ n g
tố	t ố
tốc	t ố c
tốc-kê	t ố c k ê
tối	t ố i
tốn	t ố n
tống	t ố n g
tốp	t ố p
tốt	t ố t
tồ	t ồ
tồi	t ồ i
tồm	t ồ m
tồn	t ồ n
tồng	t ồ n g
tổ	t ổ
tổn	t ổ n
tổng	t ổ n g
tỗn	t ỗ n
tỗng	t ỗ n g
tộ	t ộ
tộc	t ộ c
tộc-ngôn	t ộ c n g ô n
tội	t ộ i
tộp	t ộ p
tột	t ộ t
tớ	t ớ
tới	t ớ i
tớn	t ớ n
tớp	t ớ p
tớt	t ớ t
tờ	t ờ
tờ-ra-côm	t ờ r a c ô m
tờ-ram	t ờ r a m
tờ-ren-cốt	t ờ r e n c ố t
tờ-rô	t ờ r ô
tờ-răng-xi-to	t ờ r ă n g x i t o
tờ-rắc	t ờ r ắ c
tờ-rớt	t ờ r ớ t
tời	t ờ i
tở	t ở
tởm	t ở m
tởn	t ở n
tợ	t ợ
tợn	t ợ n
tợp	t ợ p
tụ	t ụ
tục	t ụ c
tụi	t ụ i
tụm	t ụ m
tụng	t ụ n g
tụt	t ụ t
tụy	t ụ y
tủ	t ủ
tủa	t ủ a
tủi	t ủ i
tủm	t ủ m
tủn	t ủ n
tủng	t ủ n g
tủy	t ủ y
tứ	t ứ
tứa	t ứ a
tức	t ứ c
từ	t ừ
từa	t ừ a
từng	t ừ n g
tử	t ử
tửa	t ử a
tửng	t ử n g
tửu	t ử u
tữ	t ữ
tự	t ự
tựa	t ự a
tựu	t ự u
tỳ	t ỳ
tỵ	t ỵ
tỷ	t ỷ
u	u
u-mua	u m u a
u-ra-ni	u r a n i
u-ra-ni-um	u r a n i u m
u-ran	u r a n
u-rê	u r ê
u-su	u s u
uber	u b e r
ubuntu	u b u n t u
ui	u i
ukraine	u k r a i n e
um	u m
un	u n
under	u n d e r
ung	u n g
unicity	u n i c i t y
unified	u n i f i e d
union	u n i o n
united	u n i t e d
universal	u n i v e r s a l
unlock	u n l o c k
until	u n t i l
up	u p
update	u p d a t e
upton	u p t o n
uranium	u r a n i u m
urban	u r b a n
ures	u r e s
uruguay	u r u g u a y
us	u s
usaid	u s a i d
usb	u s b
usd	u s d
utd	u t d
utility	u t i l i t y
uy	u y
uy-mua	u y m u a
uynh	u y n h
uyên	u y ê n
uyết	u y ế t
uyển	u y ể n
uân	u â n
uôm	u ô m
uông	u ô n g
uý	u ý
uých	u ý c h
uấn	u ấ n
uất	u ấ t
uầy	u ầ y
uẩn	u ẩ n
uẩy	u ẩ y
uế	u ế
uể	u ể
uốn	u ố n
uống	u ố n g
uổng	u ổ n g
uột	u ộ t
uớt	u ớ t
uở	u ở
uỳnh	u ỳ n h
uỵch	u ỵ c h
uỷ	u ỷ
v	v
va	v a
va-dơ-lin	v a d ơ l i n
va-gông	v a g ô n g
va-li	v a l i
va-ni	v a n i
va-rơ	v a r ơ
va-rơi	v a r ơ i
vac	v a c
vadim	v a d i m
vai	v a i
valdes	v a l d e s
valencia	v a l e n c i a
valentina	v a l e n t i n a
valentine	v a l e n t i n e
valerie	v a l e r i e
vali	v a l i
valverde	v a l v e r d e
vam	v a m
van	v a n
vancouver	v a n c o u v e r
vanessa	v a n e s s a
vang	v a n g
vanh	v a n h
vani	v a n i
vao	v a o
vardy	v a r d y
variable	v a r i a b l e
vasco	v a s c o
vat	v a t
vay	v a y
vaò	v a ò
vcb	v c b
vcp	v c p
ve	v e
vegas	v e g a s
velasquez	v e l a s q u e z
ven	v e n
venezia	v e n e z i a
venezuela	v e n e z u e l a
venice	v e n i c e
venus	v e n u s
veo	v e o
versace	v e r s a c e
vest	v e s t
veston	v e s t o n
vgiấy	v g i ấ y
vi	v i
vi-da	v i d a
vi-la	v i l a
vi-nhét	v i n h é t
vi-ni-lông	v i n i l ô n g
vi-rút	v i r ú t
vi-ta-min	v i t a m i n
vi-ô-lét	v i ô l é t
vi-ô-lông	v i ô l ô n g
vi-ô-lông-xen	v i ô l ô n g x e n
vi-đê-ô	v i đ ê ô
via	v i a
via-rơ-măng	v i a r ơ m ă n g
victoria	v i c t o r i a
video	v i d e o
viera	v i e r a
vietnamplus	v i e t n a m p l u s
viettel	v i e t t e l
view	v i e w
viewer	v i e w e r
vila	v i l a
villa	v i l l a
village	v i l l a g e
villarreal	v i l l a r r e a l
villas	v i l l a s
vim	v i m
vin	v i n
vina	v i n a
vinh	v i n h
vinson	v i n s o n
violin	v i o l i n
violon	v i o l o n
vip	v i p
virginia	v i r g i n i a
virus	v i r u s
visa	v i s a
vista	v i s t a
vitamin	v i t a m i n
viêm	v i ê m
viên	v i ê n
viêng	v i ê n g
viêt	v i ê t
viếng	v i ế n g
viết	v i ế t
viền	v i ề n
viển	v i ể n
viễn	v i ễ n
việc	v i ệ c
viện	v i ệ n
việp	v i ệ p
việt	v i ệ t
việt-mường	v i ệ t m ư ờ n g
việt-nam	v i ệ t n a m
vladimir	v l a d i m i r
vn	v n
vnexpress	v n e x p r e s s
vnindex	v n i n d e x
vnpt	v n p t
vo	v o
voan	v o a n
vodafone	v o d a f o n e
vogue	v o g u e
voi	v o i
voice	v o i c e
volker	v o l k e r
vom	v o m
von	v o n
von-kế	v o n k ế
von-phơ-ram	v o n p h ơ r a m
vong	v o n g
vote	v o t e
voyager	v o y a g e r
voòng	v o ò n g
voọc	v o ọ c
vtv	v t v
vu	v u
vua	v u a
vui	v u i
vun	v u n
vung	v u n g
vuông	v u ô n g
vuốt	v u ố t
vuột	v u ộ t
vy	v y
và	v à
vài	v à i
vàm	v à m
vàn	v à n
vàng	v à n g
vành	v à n h
vào	v à o
vàotrong	v à o t r o n g
vày	v à y
vá	v á
vác	v á c
vác-xin	v á c x i n
vách	v á c h
vái	v á i
ván	v á n
váng	v á n g
vánh	v á n h
váo	v á o
váp	v á p
vát	v á t
váy	v á y
vâm	v â m
vân	v â n
vâng	v â n g
vây	v â y
vã	v ã
vãi	v ã i
vãn	v ã n
vãng	v ã n g
vãnh	v ã n h
vè	v è
vèn	v è n
vèo	v è o
vé	v é
véc	v é c
véc-ni	v é c n i
véc-tơ	v é c t ơ
vén	v é n
véo	v é o
vét	v é t
vét-tông	v é t t ô n g
vét-xi	v é t x i
vê	v ê
vê-lanh	v ê l a n h
vên	v ê n
vênh	v ê n h
vêu	v ê u
vì	v ì
ví	v í
vía	v í a
vích	v í c h
vính	v í n h
vít	v í t
víu	v í u
vò	v ò
vòi	v ò i
vòm	v ò m
vòn	v ò n
vòng	v ò n g
vó	v ó
vóc	v ó c
vói	v ó i
vón	v ó n
vóng	v ó n g
vót	v ó t
vô	v ô
vô-lê	v ô l ê
vô-lăng	v ô l ă n g
vôi	v ô i
vôn	v ô n
vông	v ô n g
võ	v õ
võng	v õ n g
vù	v ù
vùa	v ù a
vùi	v ù i
vùn	v ù n
vùng	v ù n g
vú	v ú
vúc	v ú c
vút	v ú t
văn	v ă n
văng	v ă n g
văng-tê	v ă n g t ê
vĩ	v ĩ
vĩnh	v ĩ n h
vũ	v ũ
vũ-môn	v ũ m ô n
vũm	v ũ m
vũng	v ũ n g
vơ	v ơ
vơ-đét	v ơ đ é t
vơi	v ơ i
vưng	v ư n g
vưu	v ư u
vươn	v ư ơ n
vương	v ư ơ n g
vướng	v ư ớ n g
vườn	v ư ờ n
vưởng	v ư ở n g
vược	v ư ợ c
vượn	v ư ợ n
vượng	v ư ợ n g
vượt	v ư ợ t
vạ	v ạ
vạc	v ạ c
vạch	v ạ c h
vại	v ạ i
vạm	v ạ m
vạn	v ạ n
vạng	v ạ n g
vạnh	v ạ n h
vạp	v ạ p
vạt	v ạ t
vạy	v ạ y
vả	v ả
vải	v ả i
vảng	v ả n g
vảnh	v ả n h
vảy	v ả y
vấn	v ấ n
vấp	v ấ p
vất	v ấ t
vấu	v ấ u
vấy	v ấ y
vần	v ầ n
vầng	v ầ n g
vầu	v ầ u
vầy	v ầ y
vẩn	v ẩ n
vẩu	v ẩ u
vẩy	v ẩ y
vẫn	v ẫ n
vẫy	v ẫ y
vậm	v ậ m
vận	v ậ n
vập	v ậ p
vật	v ậ t
vậy	v ậ y
vắc	v ắ c
vắc-xanh	v ắ c x a n h
vắc-xin	v ắ c x i n
vắn	v ắ n
vắng	v ắ n g
vắt	v ắ t
vằm	v ằ m
vằn	v ằ n
vằng	v ằ n g
vẳng	v ẳ n g
vặc	v ặ c
vặn	v ặ n
vặt	v ặ t
vẹc	v ẹ c
vẹc-ni	v ẹ c n i
vẹm	v ẹ m
vẹn	v ẹ n
vẹo	v ẹ o
vẹt	v ẹ t
vẻ	v ẻ
vẻn	v ẻ n
vẻo	v ẻ o
vẽ	v ẽ
vế	v ế
vếch	v ế c h
vết	v ế t
vếu	v ế u
về	v ề
vền	v ề n
vều	v ề u
vểnh	v ể n h
vểu	v ể u
vệ	v ệ
vện	v ệ n
vệt	v ệ t
vỉ	v ỉ
vỉa	v ỉ a
vị	v ị
vịm	v ị m
vịn	v ị n
vịnh	v ị n h
vịt	v ị t
vọ	v ọ
vọc	v ọ c
vọi	v ọ i
vọng	v ọ n g
vọp	v ọ p
vọt	v ọ t
vỏ	v ỏ
vỏn	v ỏ n
vỏng	v ỏ n g
vố	v ố
vốc	v ố c
vối	v ố i
vốn	v ố n
vống	v ố n g
vồ	v ồ
vồi	v ồ i
vồn	v ồ n
vồng	v ồ n g
vổ	v ổ
vổng	v ổ n g
vỗ	v ỗ
vội	v ộ i
vớ	v ớ
với	v ớ i
vớt	v ớ t
vờ	v ờ
vời	v ờ i
vờn	v ờ n
vở	v ở
vởn	v ở n
vỡ	v ỡ
vợ	v ợ
vợi	v ợ i
vợt	v ợ t
vụ	v ụ
vục	v ụ c
vụn	v ụ n
vụng	v ụ n g
vụt	v ụ t
vủn	v ủ n
vức	v ứ c
vứt	v ứ t
vừa	v ừ a
vừng	v ừ n g
vửng	v ử n g
vữa	v ữ a
vững	v ữ n g
vựa	v ự a
vực	v ự c
vựng	v ự n g
vỹ	v ỹ
wagon	w a g o n
waikiki	w a i k i k i
wales	w a l e s
walking	w a l k i n g
wall	w a l l
wallis	w a l l i s
wang	w a n g
ward	w a r d
warfare	w a r f a r e
was	w a s
washington	w a s h i n g t o n
watana	w a t a n a
watch	w a t c h
watson	w a t s o n
wave	w a v e
web	w e b
website	w e b s i t e
wells	w e l l s
wendy	w e n d y
wenger	w e n g e r
west	w e s t
wharf	w h a r f
wheel	w h e e l
whelan	w h e l a n
when	w h e n
whisky	w h i s k y
wi	w i
wifi	w i f i
wild	w i l d
william	w i l l i a m
williard	w i l l i a r d
wilshere	w i l s h e r e
wilson	w i l s o n
wimbledon	w i m b l e d o n
win	w i n
windows	w i n d o w s
windsor	w i n d s o r
winters	w i n t e r s
winthrop	w i n t h r o p
with	w i t h
witt	w i t t
wolf	w o l f
wolfsburg	w o l f s b u r g
won	w o n
woo	w o o
woodside	w o o d s i d e
woody	w o o d y
worcestershire	w o r c e s t e r s h i r e
word	w o r d
world	w o r l d
x	x
xa	x a
xa-bô	x a b ô
xa-bô-chê	x a b ô c h ê
xa-ca-rin	x a c a r i n
xa-ca-rô-da	x a c a r ô d a
xa-lô	x a l ô
xa-lông	x a l ô n g
xa-mô-va	x a m ô v a
xa-phia	x a p h i a
xa-tanh	x a t a n h
xa-ten	x a t e n
xa-tăng	x a t ă n g
xa-điêng	x a đ i ê n g
xam	x a m
xan	x a n
xan-tô-nin	x a n t ô n i n
xang	x a n g
xanh	x a n h
xanh-đi-ca	x a n h đ i c a
xao	x a o
xay	x a y
xe	x e
xe-lu-lô	x e l u l ô
xe-mi-na	x e m i n a
xe-non	x e n o n
xe-re-nát	x e r e n á t
xem	x e m
xen	x e n
xen-lu-lô	x e n l u l ô
xen-luy-lô	x e n l u y l ô
xen-lô	x e n l ô
xen-ti	x e n t i
xen-tim	x e n t i m
xen-xi-út	x e n x i ú t
xen-đầm	x e n đ ầ m
xeng	x e n g
xentimét	x e n t i m é t
xeo	x e o
xeres	x e r e s
xerox	x e r o x
xhcn	x h c n
xi	x i
xi-béc-nê-tích	x i b é c n ê t í c h
xi-căng-đan	x i c ă n g đ a n
xi-lanh	x i l a n h
xi-líp	x i l í p
xi-lô	x i l ô
xi-mi-lê	x i m i l ê
xi-moong	x i m o o n g
xi-mô-kinh	x i m ô k i n h
xi-măng	x i m ă n g
xi-nhan	x i n h a n
xi-nhê	x i n h ê
xi-nê	x i n ê
xi-phông	x i p h ô n g
xi-ren	x i r e n
xi-rô	x i r ô
xi-ta	x i t a
xi-téc	x i t é c
xi-tẹc	x i t ẹ c
xi-vin	x i v i n
xi-ôn	x i ô n
xi-đa	x i đ a
xia	x i a
xiang	x i a n g
xim	x i m
xim-pô-di-um	x i m p ô d i u m
xin	x i n
xing	x i n g
xinh	x i n h
xinh-mun	x i n h m u n
xiêm	x i ê m
xiên	x i ê n
xiêu	x i ê u
xiếc	x i ế c
xiết	x i ế t
xiếu	x i ế u
xiềng	x i ề n g
xiểm	x i ể m
xiển	x i ể n
xiểng	x i ể n g
xiễn	x i ễ n
xiệp	x i ệ p
xo	x o
xo-le-no-ít	x o l e n o í t
xo-nat	x o n a t
xo-nát	x o n á t
xoa	x o a
xoai	x o a i
xoan	x o a n
xoang	x o a n g
xoay	x o a y
xoe	x o e
xoen	x o e n
xoi	x o i
xom	x o m
xon	x o n
xon-nê	x o n n ê
xong	x o n g
xoong	x o o n g
xoà	x o à
xoài	x o à i
xoàm	x o à m
xoàn	x o à n
xoàng	x o à n g
xoành	x o à n h
xoá	x o á
xoác	x o á c
xoát	x o á t
xoáy	x o á y
xoã	x o ã
xoãi	x o ã i
xoè	x o è
xoèn	x o è n
xoét	x o é t
xoăn	x o ă n
xoạc	x o ạ c
xoạch	x o ạ c h
xoạng	x o ạ n g
xoạp	x o ạ p
xoạt	x o ạ t
xoả	x o ả
xoải	x o ả i
xoảng	x o ả n g
xoắn	x o ắ n
xoẳn	x o ẳ n
xoẹ	x o ẹ
xoẹt	x o ẹ t
xoẻng	x o ẻ n g
xtơn	x t ơ n
xu	x u
xu-ba-dăng	x u b a d ă n g
xu-chiêng	x u c h i ê n g
xu-páp	x u p á p
xua	x u a
xui	x u i
xum	x u m
xun	x u n
xun-pha-mít	x u n p h a m í t
xun-phua	x u n p h u a
xun-phát	x u n p h á t
xung	x u n g
xuy	x u y
xuya	x u y a
xuya-rơ-tê	x u y a r ơ t ê
xuynh	x u y n h
xuyên	x u y ê n
xuyến	x u y ế n
xuyết	x u y ế t
xuyễn	x u y ễ n
xuân	x u â n
xuân-hè	x u â n h è
xuây	x u â y
xuê	x u ê
xuôi	x u ô i
xuý	x u ý
xuýt	x u ý t
xuất	x u ấ t
xuẩn	x u ẩ n
xuế	x u ế
xuề	x u ề
xuềnh	x u ề n h
xuể	x u ể
xuệch	x u ệ c h
xuống	x u ố n g
xuồng	x u ồ n g
xuổng	x u ổ n g
xuộm	x u ộ m
xuỳ	x u ỳ
xuỵt	x u ỵ t
xy	x y
xà	x à
xà-beng	x à b e n g
xà-bông	x à b ô n g
xà-cột	x à c ộ t
xà-lan	x à l a n
xà-lim	x à l i m
xà-lách	x à l á c h
xà-lách-xon	x à l á c h x o n
xà-lách-xoong	x à l á c h x o o n g
xà-lù	x à l ù
xà-lỏn	x à l ỏ n
xà-phòng	x à p h ò n g
xà-ích	x à í c h
xài	x à i
xàm	x à m
xàng	x à n g
xành	x à n h
xào	x à o
xàu	x à u
xá	x á
xác	x á c
xác-ca-rin	x á c c a r i n
xác-đin	x á c đ i n
xách	x á c h
xái	x á i
xám	x á m
xán	x á n
xáng	x á n g
xáo	x á o
xáp	x á p
xát	x á t
xáu	x á u
xáy	x á y
xâm	x â m
xâu	x â u
xây	x â y
xã	x ã
xè	x è
xèn	x è n
xèng	x è n g
xèo	x è o
xé	x é
xéc	x é c
xéc-măng	x é c m ă n g
xéc-ti-phi-ca	x é c t i p h i c a
xém	x é m
xén	x é n
xéo	x é o
xép	x é p
xét	x é t
xê	x ê
xê-mi-na	x ê m i n a
xê-mi-ne	x ê m i n e
xê-ri	x ê r i
xê-rê-nát	x ê r ê n á t
xên	x ê n
xênh	x ê n h
xêu	x ê u
xì	x ì
xì-	x ì
xì-cút	x ì c ú t
xì-căng-đan	x ì c ă n g đ a n
xì-gà	x ì g à
xìa	x ì a
xình	x ì n h
xìu	x ì u
xí	x í
xía	x í a
xíc	x í c
xích	x í c h
xích-lô	x í c h l ô
xích-đông	x í c h đ ô n g
xín	x í n
xính	x í n h
xít	x í t
xít-đờ-ca	x í t đ ờ c a
xíu	x í u
xòa	x ò a
xòe	x ò e
xòm	x ò m
xòng	x ò n g
xó	x ó
xóa	x ó a
xóc	x ó c
xói	x ó i
xóm	x ó m
xón	x ó n
xóng	x ó n g
xóp	x ó p
xót	x ó t
xô	x ô
xô-lê-nô-ít	x ô l ê n ô í t
xô-lít	x ô l í t
xô-nát	x ô n á t
xô-viết	x ô v i ế t
xô-đa	x ô đ a
xôi	x ô i
xôm	x ô m
xôn	x ô n
xông	x ô n g
xõa	x õ a
xõm	x õ m
xõng	x õ n g
xù	x ù
xùa	x ù a
xùi	x ù i
xùm	x ù m
xùng	x ù n g
xùy	x ù y
xú	x ú
xú-báp	x ú b á p
xú-páp	x ú p á p
xú-ve	x ú v e
xú-vơ-nia	x ú v ơ n i a
xúa	x ú a
xúc	x ú c
xúc-xích	x ú c x í c h
xúi	x ú i
xúm	x ú m
xúng	x ú n g
xúp	x ú p
xúp-de	x ú p d e
xút	x ú t
xúy	x ú y
xăm	x ă m
xăn	x ă n
xăng	x ă n g
xăng-tan	x ă n g t a n
xăng-ti-mét	x ă n g t i m é t
xăng-tô-nin	x ă n g t ô n i n
xăng-đan	x ă n g đ a n
xăng-đá	x ă n g đ á
xĩnh	x ĩ n h
xũ	x ũ
xơ	x ơ
xơ-cua	x ơ c u a
xơ-lang	x ơ l a n g
xơ-ranh	x ơ r a n h
xơ-teng	x ơ t e n g
xơ-đăng	x ơ đ ă n g
xơi	x ơ i
xơm	x ơ m
xơn	x ơ n
xư	x ư
xưa	x ư a
xưanh	x ư a n h
xưng	x ư n g
xương	x ư ơ n g
xước	x ư ớ c
xướng	x ư ớ n g
xười	x ư ờ i
xường	x ư ờ n g
xưởng	x ư ở n g
xược	x ư ợ c
xượi	x ư ợ i
xượt	x ư ợ t
xạ	x ạ
xạc	x ạ c
xạch	x ạ c h
xạm	x ạ m
xạo	x ạ o
xạp	x ạ p
xạu	x ạ u
xả	x ả
xải	x ả i
xảm	x ả m
xảnh	x ả n h
xảo	x ả o
xảu	x ả u
xảy	x ả y
xấc	x ấ c
xấp	x ấ p
xấu	x ấ u
xầm	x ầ m
xầu	x ầ u
xẩm	x ẩ m
xẩn	x ẩ n
xẩu	x ẩ u
xẩy	x ẩ y
xậm	x ậ m
xập	x ậ p
xắc	x ắ c
xắc-cốt	x ắ c c ố t
xắm	x ắ m
xắn	x ắ n
xắng	x ắ n g
xắp	x ắ p
xắt	x ắ t
xằng	x ằ n g
xẵng	x ẵ n g
xẹ	x ẹ
xẹc	x ẹ c
xẹc-ti-phi-ca	x ẹ c t i p h i c a
xẹo	x ẹ o
xẹp	x ẹ p
xẹt	x ẹ t
xẻ	x ẻ
xẻn	x ẻ n
xẻng	x ẻ n g
xẻo	x ẻ o
xẽo	x ẽ o
xế	x ế
xếch	x ế c h
xếp	x ế p
xề	x ề
xềm	x ề m
xềng	x ề n g
xềnh	x ề n h
xều	x ề u
xể	x ể
xểnh	x ể n h
xệ	x ệ
xệch	x ệ c h
xệp	x ệ p
xệt	x ệ t
xệu	x ệ u
xỉ	x ỉ
xỉa	x ỉ a
xỉn	x ỉ n
xỉnh	x ỉ n h
xỉu	x ỉ u
xị	x ị
xịch	x ị c h
xịn	x ị n
xịt	x ị t
xịu	x ị u
xọ	x ọ
xọa	x ọ a
xọc	x ọ c
xọe	x ọ e
xọi	x ọ i
xọn	x ọ n
xọp	x ọ p
xọt	x ọ t
xỏ	x ỏ
xỏa	x ỏ a
xỏng	x ỏ n g
xố	x ố
xốc	x ố c
xối	x ố i
xốn	x ố n
xống	x ố n g
xốp	x ố p
xốp-phơ	x ố p p h ơ
xốt	x ố t
xồ	x ồ
xồm	x ồ m
xồn	x ồ n
xồng	x ồ n g
xổ	x ổ
xổi	x ổ i
xổm	x ổ m
xổn	x ổ n
xổng	x ổ n g
xộc	x ộ c
xộn	x ộ n
xộp	x ộ p
xớ	x ớ
xới	x ớ i
xớn	x ớ n
xớp	x ớ p
xớt	x ớ t
xờ	x ờ
xờm	x ờ m
xở	x ở
xởi	x ở i
xởn	x ở n
xỡ	x ỡ
xợp	x ợ p
xợt	x ợ t
xụ	x ụ
xục	x ụ c
xụi	x ụ i
xụng	x ụ n g
xụp	x ụ p
xụt	x ụ t
xủ	x ủ
xủng	x ủ n g
xứ	x ứ
xức	x ứ c
xứng	x ứ n g
xừ	x ừ
xừng	x ừ n g
xử	x ử
xửa	x ử a
xửng	x ử n g
xự	x ự
xực	x ự c
y	y
y-a	y a
y-lơng	y l ơ n g
yahoo	y a h o o
yamada	y a m a d a
yamaha	y a m a h a
yamamoto	y a m a m o t o
yamase	y a m a s e
yang	y a n g
yanhee	y a n h e e
yankee	y a n k e e
yasui	y a s u i
yasukuni	y a s u k u n i
yaya	y a y a
yemen	y e m e n
yen	y e n
yes	y e s
yeti	y e t i
ymca	y m c a
yoga	y o g a
yoko	y o k o
yokota	y o k o t a
yoo	y o o
york	y o r k
yorke	y o r k e
young	y o u n g
youtube	y o u t u b e
yuichiro	y u i c h i r o
yuki	y u k i
yát	y á t
yêm	y ê m
yên	y ê n
yêng	y ê n g
yêu	y ê u
yếm	y ế m
yến	y ế n
yếp	y ế p
yết	y ế t
yếu	y ế u
yểm	y ể m
yển	y ể n
yểng	y ể n g
yểu	y ể u
z	z
zamora	z a m o r a
zane	z a n e
zealand	z e a l a n d
zeppelin	z e p p e l i n
zhang	z h a n g
zheng	z h e n g
zhivago	z h i v a g o
zimbabwe	z i m b a b w e
zing	z i n g
zinger	z i n g e r
zone	z o n e
zoom	z o o m
zuckerberg	z u c k e r b e r g
à	à
àm	à m
ành	à n h
ào	à o
á	á
ác	á c
ác-bít	á c b í t
ác-coóc	á c c o ó c
ác-coóc-đê-ông	á c c o ó c đ ê ô n g
ác-mô-ni-ca	á c m ô n i c a
ác-quy	á c q u y
ác-ten	á c t e n
ác-ti-sô	á c t i s ô
ách	á c h
ái	á i
ám	á m
án	á n
áng	á n g
ánh	á n h
áo	á o
áp	á p
áp-ga-ni	á p g a n i
áp-phe	á p p h e
áp-phích	á p p h í c h
áp-xe	á p x e
át	á t
át-lát	á t l á t
át-mốt-phe	á t m ố t p h e
át-phan	á t p h a n
át-pi-rin	á t p i r i n
át-xít	á t x í t
áy	á y
â	â
âm	â m
ân	â n
âu	â u
âu-tây	â u t â y
ây	â y
ã	ã
è	è
èng	è n g
èo	è o
é	é
éc	é c
ém	é m
én	é n
éo	é o
ép	é p
ép-phê	é p p h ê
ép-xi-lon	é p x i l o n
ét	é t
ét-coóc	é t c o ó c
ét-xe	é t x e
ét-xăng	é t x ă n g
ê	ê
ê-bô-nit	ê b ô n i t
ê-bô-nít	ê b ô n í t
ê-cu	ê c u
ê-ke	ê k e
ê-kíp	ê k í p
ê-léc-tron	ê l é c t r o n
ê-líp	ê l í p
ê-lếch-tơ-rôn	ê l ế c h t ơ r ô n
ê-mun-xi	ê m u n x i
ê-mê-tin	ê m ê t i n
ê-mơ-rốt	ê m ơ r ố t
ê-pông	ê p ô n g
ê-ri-tơ-rô-mi-xin	ê r i t ơ r ô m i x i n
ê-rô-mi-xin	ê r ô m i x i n
ê-săng-chi-ông	ê s ă n g c h i ô n g
ê-ta	ê t a
ê-te	ê t e
ê-ti-két	ê t i k é t
ê-ti-len	ê t i l e n
ê-tuýt	ê t u ý t
ê-tô	ê t ô
ê-đê	ê đ ê
êm	ê m
êu	ê u
ì	ì
ìn	ì n
ình	ì n h
í	í
ích	í c h
ích-xì	í c h x ì
ín	í n
ít	í t
ò	ò
òa	ò a
òi	ò i
òm	ò m
òn	ò n
òng	ò n g
ó	ó
óc	ó c
óe	ó e
ói	ó i
óng	ó n g
óp	ó p
ót	ó t
ô	ô
ô-boa	ô b o a
ô-dôn	ô d ô n
ô-kê	ô k ê
ô-lim-pích	ô l i m p í c h
ô-liu	ô l i u
ô-mê-ga	ô m ê g a
ô-pê-ra	ô p ê r a
ô-rê-ô-mi-xin	ô r ê ô m i x i n
ô-ten	ô t e n
ô-tô	ô t ô
ô-tô-buýt	ô t ô b u ý t
ô-tô-ca	ô t ô c a
ô-tô-ma-tích	ô t ô m a t í c h
ô-tô-mát	ô t ô m á t
ô-tô-ray	ô t ô r a y
ô-văng	ô v ă n g
ô-xi	ô x i
ô-xít	ô x í t
ôi	ô i
ôi!	ô i !
ôm	ô m
ôm-kế	ô m k ế
ôm-lét	ô m l é t
ôn	ô n
ông	ô n g
ôtô	ô t ô
õng	õ n g
ù	ù
ùa	ù a
ùm	ù m
ùn	ù n
ùng	ù n g
ùy	ù y
ú	ú
úa	ú a
úc	ú c
úi	ú i
úm	ú m
úng	ú n g
úp	ú p
út	ú t
úy	ú y
ý	ý
ă	ă
ăm	ă m
ăm-bờ-ra-da	ă m b ờ r a d a
ăm-pe	ă m p e
ăm-pun	ă m p u n
ăn	ă n
ăng	ă n g
ăng-ga	ă n g g a
ăng-kết	ă n g k ế t
ăng-lê	ă n g l ê
ăng-ten	ă n g t e n
ăng-ti-gôn	ă n g t i g ô n
ăng-ti-moan	ă n g t i m o a n
ăng-tơ-ra-xit	ă n g t ơ r a x i t
đa	đ a
đai	đ a i
đam	đ a m
đan	đ a n
đang	đ a n g
đanh	đ a n h
đao	đ a o
đau	đ a u
đay	đ a y
đe	đ e
đem	đ e m
đen	đ e n
đen-ta	đ e n t a
đeng	đ e n g
đeo	đ e o
đi	đ i
đi!	đ i !
đi-na	đ i n a
đi-na-mít	đ i n a m í t
đi-na-mô	đ i n a m ô
đi-văng	đ i v ă n g
đi-ê-den	đ i ê d e n
đi-ốp	đ i ố p
đi-ốt	đ i ố t
đia	đ i a
đicr	đ i c r
đigiúp	đ i g i ú p
đin	đ i n
đinh	đ i n h
đip	đ i p
điu	đ i u
điêm	đ i ê m
điên	đ i ê n
điêng	đ i ê n g
điêu	đ i ê u
điạ	đ i ạ
điếc	đ i ế c
điếm	đ i ế m
điến	đ i ế n
điếng	đ i ế n g
điếp	đ i ế p
điếu	đ i ế u
điềm	đ i ề m
điền	đ i ề n
điều	đ i ề u
điểm	đ i ể m
điển	đ i ể n
điểu	đ i ể u
điễn	đ i ễ n
điệm	đ i ệ m
điện	đ i ệ n
điệp	đ i ệ p
điệt	đ i ệ t
điệu	đ i ệ u
đo	đ o
đoan	đ o a n
đoi	đ o i
đom	đ o m
đon	đ o n
đong	đ o n g
đoài	đ o à i
đoàn	đ o à n
đoàng	đ o à n g
đoành	đ o à n h
đoá	đ o á
đoác	đ o á c
đoái	đ o á i
đoán	đ o á n
đoát	đ o á t
đoãng	đ o ã n g
đoạ	đ o ạ
đoạn	đ o ạ n
đoạt	đ o ạ t
đoản	đ o ả n
đoảng	đ o ả n g
đt	đ t
đu	đ u
đu-ra	đ u r a
đua	đ u a
đui	đ u i
đum	đ u m
đum-đum	đ u m đ u m
đun	đ u n
đung	đ u n g
đup	đ u p
đuy-ra	đ u y r a
đuya-ra	đ u y a r a
đuôi	đ u ô i
đuôn	đ u ô n
đuông	đ u ô n g
đuềnh	đ u ề n h
đuểnh	đ u ể n h
đuễnh	đ u ễ n h
đuốc	đ u ố c
đuối	đ u ố i
đuống	đ u ố n g
đuồn	đ u ồ n
đuổi	đ u ổ i
đuỗn	đ u ỗ n
đuột	đ u ộ t
đuờng	đ u ờ n g
đà	đ à
đài	đ à i
đàm	đ à m
đàn	đ à n
đàng	đ à n g
đành	đ à n h
đào	đ à o
đày	đ à y
đá	đ á
đác	đ á c
đác-uyn	đ á c u y n
đách	đ á c h
đái	đ á i
đám	đ á m
đán	đ á n
đáng	đ á n g
đánh	đ á n h
đáo	đ á o
đáp	đ á p
đát	đ á t
đáu	đ á u
đáy	đ á y
đâm	đ â m
đâu	đ â u
đây	đ â y
đã	đ ã
đãi	đ ã i
đãn	đ ã n
đãng	đ ã n g
đãy	đ ã y
đè	đ è
đèm	đ è m
đèn	đ è n
đèo	đ è o
đé	đ é
đéc	đ é c
đém	đ é m
đén	đ é n
đéo	đ é o
đét	đ é t
đét-xe	đ é t x e
đê	đ ê
đê-ca	đ ê c a
đê-xi	đ ê x i
đê-xi-ben	đ ê x i b e n
đê-ông	đ ê ô n g
đêm	đ ê m
đên	đ ê n
đênh	đ ê n h
đêu	đ ê u
đì	đ ì
đìa	đ ì a
đìn	đ ì n
đình	đ ì n h
đìu	đ ì u
đìện	đ ì ệ n
đí	đ í
đía	đ í a
đích	đ í c h
đính	đ í n h
đíp-lôm	đ í p l ô m
đít	đ í t
đít-cua	đ í t c u a
đò	đ ò
đòi	đ ò i
đòm	đ ò m
đòn	đ ò n
đòng	đ ò n g
đó	đ ó
đóa	đ ó a
đóc	đ ó c
đói	đ ó i
đóm	đ ó m
đón	đ ó n
đóng	đ ó n g
đóp	đ ó p
đót	đ ó t
đô	đ ô
đô-la	đ ô l a
đô-mi-nô	đ ô m i n ô
đô-ping	đ ô p i n g
đôc	đ ô c
đôgn	đ ô g n
đôi	đ ô i
đôla	đ ô l a
đôm	đ ô m
đôn	đ ô n
đông	đ ô n g
đông-bắc	đ ô n g b ắ c
đông-dương	đ ô n g d ư ơ n g
đông-nam	đ ô n g n a m
đông-phương	đ ô n g p h ư ơ n g
đông-xuân	đ ô n g x u â n
đôị	đ ô ị
đõ	đ õ
đù	đ ù
đùa	đ ù a
đùi	đ ù i
đùm	đ ù m
đùn	đ ù n
đùng	đ ù n g
đú	đ ú
đúa	đ ú a
đúc	đ ú c
đúm	đ ú m
đún	đ ú n
đúng	đ ú n g
đúp	đ ú p
đúp-lê	đ ú p l ê
đút	đ ú t
đăk	đ ă k
đăm	đ ă m
đăng	đ ă n g
đăng-ten	đ ă n g t e n
đĩ	đ ĩ
đĩa	đ ĩ a
đĩnh	đ ĩ n h
đũa	đ ũ a
đũi	đ ũ i
đũng	đ ũ n g
đơ	đ ơ
đơ-ro	đ ơ r o
đơm	đ ơ m
đơn	đ ơ n
đưa	đ ư a
đưng	đ ư n g
đươc	đ ư ơ c
đương	đ ư ơ n g
đước	đ ư ớ c
đướu	đ ư ớ u
đười	đ ư ờ i
đườn	đ ư ờ n
đường	đ ư ờ n g
đưỡn	đ ư ỡ n
được	đ ư ợ c
đượi	đ ư ợ i
đượm	đ ư ợ m
đạ	đ ạ
đạc	đ ạ c
đạch	đ ạ c h
đại	đ ạ i
đại-dương-châu	đ ạ i d ư ơ n g c h â u
đạm	đ ạ m
đạn	đ ạ n
đạo	đ ạ o
đạp	đ ạ p
đạt	đ ạ t
đạt-lai	đ ạ t l a i
đả	đ ả
đảm	đ ả m
đản	đ ả n
đảng	đ ả n g
đảnh	đ ả n h
đảo	đ ả o
đảy	đ ả y
đấm	đ ấ m
đấng	đ ấ n g
đất	đ ấ t
đấu	đ ấ u
đấy	đ ấ y
đầm	đ ầ m
đần	đ ầ n
đầu	đ ầ u
đầy	đ ầ y
đẩu	đ ẩ u
đẩy	đ ẩ y
đẫm	đ ẫ m
đẫn	đ ẫ n
đẫy	đ ẫ y
đậm	đ ậ m
đận	đ ậ n
đập	đ ậ p
đật	đ ậ t
đậu	đ ậ u
đậy	đ ậ y
đắc	đ ắ c
đắk	đ ắ k
đắm	đ ắ m
đắn	đ ắ n
đắng	đ ắ n g
đắp	đ ắ p
đắt	đ ắ t
đằm	đ ằ m
đằn	đ ằ n
đằng	đ ằ n g
đẳm	đ ẳ m
đẳng	đ ẳ n g
đẵm	đ ẵ m
đẵn	đ ẵ n
đẵng	đ ẵ n g
đặc	đ ặ c
đặm	đ ặ m
đặn	đ ặ n
đặng	đ ặ n g
đặt	đ ặ t
đẹn	đ ẹ n
đẹp	đ ẹ p
đẹt	đ ẹ t
đẻ	đ ẻ
đẻn	đ ẻ n
đẽ	đ ẽ
đẽo	đ ẽ o
đế	đ ế
đếch	đ ế c h
đếm	đ ế m
đến	đ ế n
đề	đ ề
đề-bô	đ ề b ô
đề-ca	đ ề c a
đề-can	đ ề c a n
đề-ma-rơ	đ ề m a r ơ
đề-mác	đ ề m á c
đề-mốt-đê	đ ề m ố t đ ê
đề-pa	đ ề p a
đề-pô	đ ề p ô
đề-sạc	đ ề s ạ c
đề-xi-ben	đ ề x i b e n
đề-xi-la	đ ề x i l a
đề-xi-mét	đ ề x i m é t
đềm	đ ề m
đền	đ ề n
đềnh	đ ề n h
đều	đ ề u
để	đ ể
đểm	đ ể m
đểnh	đ ể n h
đểu	đ ể u
đễ	đ ễ
đễnh	đ ễ n h
đệ	đ ệ
đệm	đ ệ m
đệp	đ ệ p
đệt	đ ệ t
đỉa	đ ỉ a
đỉnh	đ ỉ n h
địa	đ ị a
địch	đ ị c h
định	đ ị n h
địt	đ ị t
địu	đ ị u
đọ	đ ọ
đọa	đ ọ a
đọan	đ ọ a n
đọc	đ ọ c
đọi	đ ọ i
đọn	đ ọ n
đọng	đ ọ n g
đọp	đ ọ p
đọt	đ ọ t
đỏ	đ ỏ
đỏa	đ ỏ a
đỏi	đ ỏ i
đỏm	đ ỏ m
đỏng	đ ỏ n g
đố	đ ố
đốc	đ ố c
đốc-tơ	đ ố c t ơ
đốc-tờ	đ ố c t ờ
đối	đ ố i
đốm	đ ố m
đốn	đ ố n
đống	đ ố n g
đốp	đ ố p
đốt	đ ố t
đốt-xi-ê	đ ố t x i ê
đồ	đ ồ
đồi	đ ồ i
đồm	đ ồ m
đồn	đ ồ n
đồng	đ ồ n g
đổ	đ ổ
đổi	đ ổ i
đổng	đ ổ n g
đỗ	đ ỗ
đỗi	đ ỗ i
đỗng	đ ỗ n g
độ	đ ộ
độc	đ ộ c
đội	đ ộ i
độn	đ ộ n
động	đ ộ n g
độp	đ ộ p
đột	đ ộ t
đớ	đ ớ
đới	đ ớ i
đớn	đ ớ n
đớp	đ ớ p
đớt	đ ớ t
đờ	đ ờ
đờ-mi	đ ờ m i
đờ-măng	đ ờ m ă n g
đờ-o	đ ờ o
đời	đ ờ i
đờm	đ ờ m
đờn	đ ờ n
đở	đ ở
đởm	đ ở m
đởn	đ ở n
đỡ	đ ỡ
đợ	đ ợ
đợi	đ ợ i
đợp	đ ợ p
đợt	đ ợ t
đụ	đ ụ
đục	đ ụ c
đụi	đ ụ i
đụn	đ ụ n
đụng	đ ụ n g
đụp	đ ụ p
đụt	đ ụ t
đủ	đ ủ
đủi	đ ủ i
đủng	đ ủ n g
đứ	đ ứ
đứa	đ ứ a
đức	đ ứ c
đứng	đ ứ n g
đứt	đ ứ t
đừ	đ ừ
đừa	đ ừ a
đừng	đ ừ n g
đử	đ ử
đực	đ ự c
đựng	đ ự n g
ĩ	ĩ
ĩnh	ĩ n h
ơ	ơ
ơ-rô	ơ r ô
ơ-đu	ơ đ u
ơi	ơ i
ơi!	ơ i !
ơi-ê	ơ i ê
ơn	ơ n
ư	ư
ưa	ư a
ưng	ư n g
ưu	ư u
ươi	ư ơ i
ươm	ư ơ m
ươn	ư ơ n
ương	ư ơ n g
ước	ư ớ c
ướm	ư ớ m
ướp	ư ớ p
ướt	ư ớ t
ườn	ư ờ n
ưởng	ư ở n g
ưỡn	ư ỡ n
ạ	ạ
ạch	ạ c h
ạnh	ạ n h
ạo	ạ o
ạt	ạ t
ả	ả
ải	ả i
ảm	ả m
ảng	ả n g
ảnh	ả n h
ảo	ả o
ấm	ấ m
ấn	ấ n
ấp	ấ p
ất	ấ t
ấu	ấ u
ấy	ấ y
ấylắc	ấ y l ắ c
ầm	ầ m
ầng	ầ n g
ầu	ầ u
ầy	ầ y
ẩm	ẩ m
ẩn	ẩ n
ẩng	ẩ n g
ẩu	ẩ u
ẩy	ẩ y
ẫm	ẫ m
ậc	ậ c
ậm	ậ m
ập	ậ p
ậu	ậ u
ắc	ắ c
ắc-coóc	ắ c c o ó c
ắc-coóc-đê-ông	ắ c c o ó c đ ê ô n g
ắc-qui	ắ c q u i
ắc-quy	ắ c q u y
ắc-xi-đăng	ắ c x i đ ă n g
ắc-ê	ắ c ê
ắng	ắ n g
ắp	ắ p
ắt	ắ t
ằng	ằ n g
ẳng	ẳ n g
ẵm	ẵ m
ặc	ặ c
ặp	ặ p
ẹ	ẹ
ẹc	ẹ c
ẹo	ẹ o
ẹp	ẹ p
ẹt	ẹ t
ẻn	ẻ n
ẻo	ẻ o
ẽo	ẽ o
ế	ế
ếch	ế c h
ếm	ế m
ếp	ế p
ề	ề
ềnh	ề n h
ễng	ễ n g
ễnh	ễ n h
ệ	ệ
ệch	ệ c h
ện	ệ n
ệnh	ệ n h
ệp	ệ p
ệt	ệ t
ỉ	ỉ
ỉa	ỉ a
ỉm	ỉ m
ỉn	ỉ n
ỉu	ỉ u
ị	ị
ịch	ị c h
ịn	ị n
ịnh	ị n h
ịt	ị t
ọ	ọ
ọc	ọ c
ọe	ọ e
ọi	ọ i
ọp	ọ p
ọt	ọ t
ỏ	ỏ
ỏc	ỏ c
ỏe	ỏ e
ỏi	ỏ i
ỏm	ỏ m
ỏn	ỏ n
ỏng	ỏ n g
ố	ố
ốc	ố c
ối	ố i
ốm	ố m
ống	ố n g
ốp	ố p
ốp-lét	ố p l é t
ốp-lết	ố p l ế t
ốp-sét	ố p s é t
ốp-ti-man	ố p t i m a n
ốp-xét	ố p x é t
ốt	ố t
ồ	ồ
ồi	ồ i
ồm	ồ m
ồn	ồ n
ồng	ồ n g
ổ	ổ
ổ-líp	ổ l í p
ổi	ổ i
ổm	ổ m
ổn	ổ n
ổng	ổ n g
ộ	ộ
ộc	ộ c
ộn	ộ n
ộp	ộ p
ột	ộ t
ớ	ớ
ới	ớ i
ớm	ớ m
ớn	ớ n
ớt	ớ t
ờ	ờ
ời	ờ i
ờn	ờ n
ở	ở
ởn	ở n
ỡm	ỡ m
ợ	ợ
ợi	ợ i
ợt	ợ t
ụ	ụ
ụa	ụ a
ục	ụ c
ụp	ụ p
ụt	ụ t
ủ	ủ
ủ-su	ủ s u
ủa	ủ a
ủi	ủ i
ủn	ủ n
ủng	ủ n g
ủy	ủ y
ứ	ứ
ứa	ứ a
ức	ứ c
ứng	ứ n g
ừ	ừ
ừm	ừ m
ừng	ừ n g
ử	ử
ửng	ử n g
ửu	ử u
ự	ự
ựa	ự a
ực	ự c
ỳ	ỳ
ỷ	ỷ
ỹ	ỹ
